0000000000000000
0000000000000000
0000000000000000
0000000000000000
0000000000000000
0000000000000000
0000022222222003
0001111111111111
0000000000000000
0000000000000000
0000000000000000
0000021111111111
0000000000000000
0000000000000000
0000000000030001
0001111111111111
