0000000000000000
0000000000000000
0000000000000000
0000000000000000
0000000000000222
0000000000000222
0111000000001111
0000000000000000
0000000000000000
0000000000000000
0000000000000000
0000003000003000
0000011000011000
0000011000011000
0000111100111111
0000000000000000
