0000000000000000
0000000000000000
0000000000000000
0000000000000000
0000000000000000
0010000000000000
0000000000000000
1101100000000000
1101100000000000
0000000000000000
1010111000000000
1010111000002222
1111111000000000
0101011000000000
0101011000000000
1111111111111111
