0000000000000000
0000000000000000
0000000000000000
0000000000000000
0030000000000000
0110000000000000
0110000000000000
0110000000000000
0000000000000000
0000000000000000
0000000000000000
0000000000000000
0000000000000000
0000000001000000
0000000001000033
0000000001111111
