0000000000000000
0000000000000000
0000000000000000
0000000000000000
1111111111111111
0000000000000000
0000000000000000
0000000000000000
0000000000000000
0000000000300000
0000000001100000
0300000001100000
1100000001100110
1100011001100110
1100011001100110
1100011001100110
