0000000000000000
0000000000000000
0000000000000000
0000000000000000
0000000000000000
0000000000000000
0000000000000000
0000000000022000
0000000000000000
0000000000000000
0000000000220000
0000000000000000
1111110000000000
0000000000000000
0000000001111111
0000000001000000
