0000000000000000
0000000000000000
0000000000000000
1111111111111111
1000000000000000
1000000030000000
1000222222000000
1000000000000000
1000000000000000
1000000000000000
1000111111111111
1000111111111111
0000111111111111
0000111111111111
1300111111111111
1100111111111111
