0000000000000000
0000000000000000
0000000000000000
0000000000000000
0000000000000000
0000000000000000
0000000000000000
0000000000000000
0000000000000000
0000000000000000
0000022220000000
0000000000000000
0000000300000000
0000000000000000
1111111111111111
1111111111111111
