0000000000000000
0000000000000000
0000000000000000
0000000000000000
0000000111001111
0000000000001111
0000000000001111
0000000000001111
0000000000001111
0000000000001111
0000000000000111
0000000000000111
1110100111111111
1110100111111111
1110100111111111
1110100111111111
