0000000000000000
0000000000000000
0000000000000000
0000000000000000
0000000000000000
0000000000000000
0000000000000000
0000000000000000
0000000000000000
0000000000000000
0000000000030020
2200000000110000
0000000000110000
0000000000110000
0000300000110000
1111111111111111
