0000000000000000
0000000000000000
0000000000000000
0000000000000000
0000000000000000
0000000000000000
0000000000000000
0000000000000000
0000000000000001
0000000000000011
0000000000000111
0000000000001111
0000000000011111
0000000000111111
1100001111111111
1100001111111111
