0000000000000000
0000000000000000
0000000000000000
0000000000000000
0000000000000000
0000000000000000
0000000000000000
0000000000000000
0000000000000000
0000000000000000
0000000000022220
0003000000000000
0011000000000000
0011000000000000
0011000000330000
0011111111111111
