0000000000000000
0000000000000000
0000000000000000
0000000000000000
0000000000000000
0000000000000000
0000000000000000
0001000000000000
0011000000000000
0111000000000000
1111000000000000
1111000000000000
1111000000000000
1111000000000000
1111111111111111
1111111111111111
