0000000000000000
0000000000000000
0000000000000000
0000000000000000
1111111111111000
0000000011111000
0000000011111000
0000000011111000
0000000011111000
0000000011111000
0000030011111000
0000110000011000
0000110000011000
0000110000011000
0000110000033000
0011111111111111
