0000000000000000
0000000000000000
0000000000000000
0000000000000000
0000000000000000
0000000000000000
0000000000000000
0000000000000000
0000000000000000
0000000000000000
1111110000000000
0000000000000000
0000000000000000
0300000000000000
1111111111111111
1111111111111111
