0000000000000000
0000000000000000
0000000000000000
0000000000000000
0000000000000000
0000000000000000
0000000000030000
0000000111111111
0000000000000000
0000000000000000
0000000000000000
0000000000000001
0000000000100000
0000000000100000
0000000000100000
1001011111111111
