0000000000000000
0000000000000000
0000000000000000
0000000000000000
0000000000000000
0000000000000000
0000000000000000
0000000000000000
0000300000000000
0000000000000000
0000000000000000
0000000000000000
0000001111111100
0000000000000000
1110000000000000
0010000000000000
