0000000000000000
0000000000000000
0000000000000000
0000000000000000
0000000000000000
0000000000000000
0111100000000000
0011000000000000
0011000000000000
0011000000000000
0011000000000000
0011000000000003
0000000000000011
0003000000000011
1111111131111111
1111111111111111
