0000000000000000
0000000000000000
0000000000000000
0000000000000000
0000000000000000
0000000000000000
1000001111100000
0000000110000000
0000000110000000
0002000110000000
0000000110000000
0000000000000000
0000000030000000
0000010000000000
1111110111111131
1111110111111111
