0000000000000000
0000000000000000
0000000000000000
0000000000000000
0000000000000003
0000000000000000
0000000000000000
0000000000000000
0000000000000000
0000000000000000
0000000001000100
0000001000000000
0000001000000000
0000001000000000
0000001000000001
1111111000011111
