0000000000000000
0000000000000000
0000000000000000
0000000000000000
0000000000000000
0000000000000000
0000000000000000
0000000000000000
0000300000000000
0000000000000000
0000000022222000
0000000111111100
0000000000000000
0000000000000000
0000000000000000
0000000000000111
