0000000000000000
0000000000000000
0000000000000000
0000000000000000
0000000000000000
0000000000000000
0000000000000000
0000000000000000
0000000000000000
0000000000002222
0000000000000000
0110000000000000
0111000000000000
0111100000003000
0111110000011000
0111111000011000
