0000000000000000
0000000000000000
0000000000000000
0000000011110000
0000000001100000
0000000001100000
0000000001100000
0000000000000000
0000000000300000
0000000000000000
0000000000000001
0000000000003011
0000000000011111
0000000000011111
1111111000011111
1111111000011111
