0000000000000000
0000000000000000
0000000000000000
0000000000000000
0000000000000000
0000000000000000
1000000000000222
0000000000000000
0000000000000000
0000000000000000
1000002222000100
0000000000000000
0000000000000000
0000000000000033
1000011111111111
1000011111111111
