0000000000000000
0000000000000000
0000000000000000
0000000000000000
1111111111111000
0000000000000000
0000000000000000
0000000000000000
0000000000000000
0030000000000000
0110000000000000
0110000000000000
0110011000003000
0110011000011000
0110011000011000
0110011001111111
