0000000000000000
0000000000000000
0000000000000000
0000000000000000
0000000000000000
0000300000000000
0001100000000000
0011100000000000
0111100000000000
3111100000000000
1111100000000000
1111100000000000
1111100000000001
1111100000000101
1111111111111111
1111111111111111
