0000000000000000
0000000000000000
0000000000000000
0000000000000000
0000000000000000
0000000000000000
0000000000000000
0000000000000000
0000000000000000
0000000000001000
0000000000000000
0000300000000000
0001100000001000
0001100003001000
1111111111111111
1111111111111111
