0000000000000000
0000000000000000
0000000000000000
0000000000000000
0000000000000000
0000000000000000
0000000000000000
0000000000000000
0000000000000000
0000000000000000
0003002000000000
0011000000000000
0011000000000000
0011000000000000
0011000003030000
1111111111111111
