0000000000000000
0000000000000000
0000000000000000
0000000000000000
0000000000000000
0300000000000000
1111111110000000
0000000000000000
0000000000000000
0003000000000000
1111211110000022
0000000000000000
0000000000000000
0000000000000000
1111111110000111
1111111110000111
