0000000000000000
0000000000000000
0000000000000000
0000000000000000
0000000000000000
0000000000000000
0000000000000000
0000000000000000
1100000000000000
1000000000000000
0000000000000000
0000000000000000
0000000000001100
1000001100001100
1000001100001100
1000001100001100
