0000000000000000
0000000000000000
0000000000000000
0000000000000000
0000000000000000
0000000000000000
0000000000000000
0000000000000000
0000000000022220
0000000000000000
2220000000000000
0000000000000000
0000000000000000
0000000000000000
0000330000000000
1111111111111111
