0000000000000000
0000000000000000
0000000000000000
1111111111111111
1111111111100000
1111111111100000
1111111111100000
0000000000000000
0000000000000000
0000000000300110
0011111111100110
0000000000000110
1000000000000110
1000000000000110
1111111111111111
1111111111111111
