0000000000000000
0000000000000000
0000000000000000
0000000000000000
0000000000000000
2000000000000000
1000011111111111
0000000000000000
0000000000000000
0000000000000000
0001000000000000
0000000000000300
0000000000001100
0000000000001100
1100000000001111
1100000000001111
