0000000000000000
0000000000000000
0000000000000000
0000000000000000
0000000000000000
0000000000000000
0000000000000000
0000000000000000
0000000000000000
0000000000000000
0000000000000300
1111111111111111
1000000000000000
0000000000000000
0000000000000000
0000000000000000
