0000000000000000
0000000000000000
0000000000000000
0000000000000000
0000000000000000
0000000000000000
0000000000000000
0000000000000000
0000000000000000
0000000000000000
0000300000000000
0000000002222222
1000000000000000
0000000000000300
0000111111111111
0000100000000000
