0000000000000000
0000000000000000
0000000000000000
0000000000000000
0000000000000000
0000000000000000
0000000000000000
0000000000000000
0000000000000000
0000000000022220
0000000000022220
1001000000000000
1001000000000000
1001000011111111
1001000010000000
1001000010000000
