0000000000000000
0000000000000000
0000000000000000
0000000000000000
0000000000000000
0000000000000000
0000000000000000
0000000000000000
0000000030000000
0000000110000000
0002220110000000
0000000110000000
0000000110000000
0010000110000000
1111111111111111
1111111111111111
