0000000000000000
0000000000000000
0000000000000000
0000000000000000
0000000000000000
0000000000000000
0000000000000000
0000000000000000
0000000000000000
0000000000000000
0030000000000000
0000000000000000
0000000000000000
0000000000000000
1110000111000011
1110000111000011
