0000000000000000
0000000000000000
0000000000000000
0000000000000000
1111111111111000
1111111111111000
1111111111111000
1111111111111000
1111111111111000
1111111111111000
1111111111111000
1111111111111000
1111111111111000
1111111111111001
1111111111111001
1111111111111001
