0000000000000000
0000000000000000
0000000000000000
0000000000000000
0000000000000000
0000000000000000
0000000000000011
0000000000000000
0003000000000000
0000000000000000
1111111000000000
1000000000000001
0000000000000011
0000000000000111
0000000000000111
0000000000000111
