0000000000000000
0000000000000000
0000000000000000
0000000000000000
0000000000000000
0000000000000000
0000000000000000
0000000000000000
0000000000000000
0000000000000000
0000222000000000
0000000000000000
0000000000000000
0000000000000100
3303000000000110
1111111100000111
