0000000000000000
0000000000000000
0000000000000000
0000000000000000
0000000000000000
2222000000000000
1111100000000000
0000000000011100
0000000000000000
0000000000020200
0000000000020201
0000000000000000
0000000000000000
0000000000000000
0000000000000000
0000000000000000
