0000000000000000
0000000000000000
0000000000000000
0000000000000000
0000000000000000
0000000000000000
0000000111000000
0000000000000000
0000000000000000
0000000000000000
1100000000001100
0000000000000000
0000000000000000
0000000000000000
0001131111000000
0000000000000000
