0000000000000000
0000000000000000
0000000000000000
0000000000000000
0000000000000000
0000000000000000
2000000000000000
3000000000000000
0003000000000000
0011000000003003
0011000000011001
0011000110011001
0011000110011001
0011000110011001
1111000110011111
1111000110011111
