0000000000000000
0000000000000000
0000000000000000
0000000000000000
0000000000000000
0000000000000000
0000000000000000
0000000000000000
0000000000000000
0100000000000002
1100000000000002
0000000000000000
0000000000000000
0000000000000000
1111331311111111
1111111111111111
