0000000000000000
0000000000000000
0000000000000000
0000000000000000
0000000000000000
0000000000000000
0200000000000000
0000000000000000
0000000000000011
0000000020220000
3100000111311000
0000000000000000
0000000000000000
0000000000000000
0000000000000000
0000000000000000
