0000000000000000
0000000000000000
0000000000000000
0000000000000000
1111111111000000
0000000000000000
0000000000000000
0000000000000000
0000000000000000
0000000000000111
0000000000000000
0000000111000000
0000000000000000
0000000000000000
0001000000000000
1111000000000111
