0000000000000000
0000000000000000
0000000000000000
0000000000000000
0000000000000000
0000000000000000
1100001000110000
0000000000000000
0000000022222220
2220000022222220
1110000000000030
0000000000000110
0000000030000110
0000000110000110
0000000110000110
0000000110000110
