0000000000000000
0000000000000000
0000000000000000
0000000000000000
0000000000000000
0000000000000000
0000000000000000
1000000000000000
1000000000000000
1000000001033000
1000000001111111
0000000000000000
0000000000000000
0000000000000000
1111110011111111
1111110011111111
