0000000000000000
0000000000000000
0000000000000000
0003000000000000
0011000000000000
0011000000000000
1111100000000000
0000000000000000
0000001110000000
0000000000000000
0000000000000000
0000000000000000
0000000000000000
0000000000011100
0000000000000000
0000000000000000
