0000000000000000
0000000000000000
0000000000000000
1111111100000000
0000000000000010
0000000000000000
0000000000000000
0111111110100000
0111111100000000
0111111000000000
2111110000000000
0000000000000000
0000000000000010
0000000000000000
1111111100000000
1111111100100000
