0000000000000000
0000000000000000
0000000000000000
0000000000000000
0000000000000000
0000000000000000
0000000000000000
0000000000000000
0000000000000000
0000000030003000
0000000000000000
1000111000011100
0000110000011000
0000000000000000
0000000000000000
0000000000000000
