0000000000000000
0000000000000000
0000000000000000
0000000000000000
0000000000000000
0000000000000000
0000000022222222
0000000000000000
0000000000000000
0000000000000000
0000000000111111
0000000000000000
0000000003000300
0000000000000000
1111111111111111
1111111111111111
