0000000000000000
0000000000000000
0000000000000000
0000000000000000
0000000000000000
0000000000000000
0000000000220000
0000000000000000
0000000000000000
0000000000000000
2222200000000000
1111110000000200
0000000000000000
0000000000000000
0000000000000000
0000011101110000
