0000000000000000
0000000000000000
0000000000000000
0000000000000000
0000000000000000
0000000000000000
0000000000000000
0000000000000000
0000000000000000
0000000000000000
0000000000131110
0000000000000000
0000000000000000
0000000000000000
1111331311000000
0000000000000000
