0000000000000000
0000000000000000
0000000000000000
0000000000000000
0000000000000000
0000000000000000
0000001100000000
0000001100000000
0000001100000000
0000001100000000
0000001111111100
0000000000000000
1000000300000000
1110000003000000
1111111111111111
1111111111111111
