0000000000000000
0000000000000000
0000000000000000
0000000000000000
0000000000000000
0000000000000000
0000000000000000
0000000000000000
0000000000000000
2200000000000000
0000000000000000
0000000000000000
0000000000000300
0000000000000000
0011000330000000
0001111111111111
