0000000000000000
0000000000000000
0000000000000000
1111111111111111
0000000000000000
0000000000000000
0000000000000000
1100000000000000
1100111110000000
1100111110002000
1100111112112111
0000000000001111
0011000000001111
0011000000000000
1111111111111101
1111111111111101
