0000000000000000
0000000000000000
0000000000000000
0000000000000000
0000000000000000
0000000000000000
0000000000000000
0000000300000000
0000001100000000
0000001100000000
0030001100000000
0110022220000000
0110000000000000
0110000000000000
0110000003000000
1111000001000111
