0000000000000000
0000000000000000
0000000000000000
0000000000000000
0000000000000000
0000000000000000
1000000000000000
0000000000000000
0011111111000000
0111111110000000
1111000000000000
1111000000000000
1111000000000000
1110000110000011
1110000110000011
1110000110000011
