0000000000000000
0000000000000000
0000000000000000
0000000000000000
0000000000000000
0000000000000000
0000000000000000
0000000020000000
0000000000000000
0000000000000000
0000000020000000
0000030010000000
0000110000000000
0000110001000011
0000113001000011
1111111111000011
