0000000000000000
0000000000000000
0000000000000000
0000000000000000
0000000000000000
0000000000000000
2222222222222222
0000000000000011
0000000000000011
0000000000000011
0011111111111011
0000000000000000
0300030000000003
0000000000000003
1111111111111111
1111111111111111
