0000000000000000
0000000000000000
0000000000000000
0000000000000000
0000000000000000
0000000000000000
0000000000000000
0000000000000000
0000000000000000
0000000000000002
0000000000000002
0000000000000003
0000000000000000
0000011131111111
0000010000000100
0000010000000100
