0000000000000000
0000000000000000
0000000000000000
0000000000000000
0000000000000000
0000000000000000
0000000000000000
0000000000000000
0000000000000000
0000000000000001
0000000000022201
0000000000000001
0000000000000001
0000000000100001
1111111111111111
1111111111111111
