0000000000000000
0000000000000000
0000000000000000
0000000000000000
0000000000000000
0000000000000000
0000000000000000
0000000000000000
0000000000000000
2200000000000000
2200000000000000
0000000000000022
0000000000000022
0000000000000000
1111331311111111
1111111111111111
