0000000000000000
0000000000000000
0000000000000000
0000000000000011
0000001000000000
0000000000000000
0000000000000000
1010000000010000
0000000000000000
0000000000000000
0000000000000000
0000000000000000
0000001000000022
0000000000000022
0000000000000011
0010000000010011
