0000000000000000
0000000000000000
0000000000000000
0000000000000000
0000000000000000
0000000000000000
0000000000000000
1111110000000000
0000000000000000
0000000000000000
0000000000000000
0001100000000000
0001100000000000
0001100000000000
0001100000000000
0001100111111111
