0000000000000000
0000000000000000
0000000000000000
0000000000000000
0000000000000000
0000000000000000
0000000000000000
0011000000000301
0111000000300000
1111000000000000
1111000000000000
1111000000000000
1111000000000000
1111000000000000
1111000000000000
1111000000000011
