0000000000000000
0000000000000000
0000000000000000
0000000000000000
0000000000000000
0000000000000000
0000000000000000
0000000000000000
0000000000000000
0000000000000000
0000000000002220
0000000000000000
0000000000000000
0000000000000000
0000300033030000
1111111111111111
