0000000000000000
0000000000000000
0000000000000000
0000000000000000
0000000000000000
0000000000000000
0000000000000000
0000000000000000
0000000000000000
0000000000000000
0000000022200000
0000000000000000
0000000000000000
0000000000000000
3003303000003300
1111111111111111
