0000000000000000
0000000000000000
0000000000000000
0000000000000000
1111100000111111
0000000000111100
0000000000111100
0000000000111100
0000000000000000
0000000000000000
0000000000020000
0000000000121100
0000300000111000
0001100000110000
0001100000003033
0111111111110111
