0000000000000000
0000000000000000
0000000000000000
0000000000000000
0000000000000000
0000000000000000
0000000000000000
0000000000000000
0000000000000000
0000000000000000
0300000000000000
2220000000000010
0000000000000010
0000001100000010
0000001100000010
1110001111111110
