0000000000000000
0000000000000000
0000000000000000
1111111111111111
1111111111111111
1111111111111111
1111111111111111
0000000000000000
0000000000000000
0000000000000000
1111120000111111
0000000000000000
0000000110000000
0000000110000000
1111111111111111
1111111111111111
