0000000000000000
0000000000000000
0000000000000000
0000000000000000
0000000000000000
0000000000000000
0000000000000000
0000000000000000
0000000000000000
0000000000000000
0000000000000000
0222222222001110
0000000000000000
0000030000000000
1111111111000000
0000000001000000
