0000000000000000
0000000000000000
0000000000000000
0000000000000000
0000000000000000
0000000000000000
0000000001110000
0000000000000000
1000000000000000
0000000000000000
0000000000000000
0000000000000030
0000000000000110
0001110000000110
0000000000001111
0000000000000000
