0000000000000000
0000000000000000
0000000000000000
0000000000000000
0000000000000000
0000000000000000
0001000000000000
0000000000000000
0000000000000000
0000000000300000
2000000001100000
0000110001100000
0000110001100000
0000110001100001
1110110011111011
1110110011111011
