0000000000000000
0000000000000000
0000000000000000
0000000000000000
0000000000000000
0000000000000000
0000000000000000
0000000000000000
0000000000000000
0000000000000220
0000000000000000
0000000000000000
0000000000000000
0000000000000000
1111111111111110
1111111111111110
