0000000000000000
0000000000000000
0000000000000000
1111111111111111
1111111110000000
1111111110000000
1111111110000000
0000000000000000
0000000000000000
0000000000000000
0000011110000000
0111011110000000
1111011110000000
1111011110000000
1111011111131111
1111011111111111
