0000000000000000
0000000000000000
0000000000000000
0000000000010000
0000000000000000
0000000000000000
0000000001111000
0000000001110000
0000000000000000
0000000000000000
0000000000000000
0011100000000000
0011000000000000
0000000011000000
0000000011111111
0000000011111111
