0000000000000000
0000000000000000
0000000000000000
0000000000000000
0000000000000000
0000000000000000
0030303000000000
0111111000000000
0111111000000000
0222222000000000
0000000000000000
0000000000000300
0000000000001100
0000000000001100
0111111111111110
0111111111111110
