0000000000000000
0000000000000000
0000000000000000
0000000000000000
0000000000000000
0000000000000000
0000000000000000
0000000000000000
0000000000000000
0000000000000000
0000110000000000
0001110000000000
0011110000000000
0111110000000000
0111111111111111
0111111111111111
