0000000000000000
0000000000000000
0000000000000000
0000000000000000
0000000000000000
0000000000000000
0000000000000000
0000003110000000
0000031110000000
0000311110000000
0100111110000000
0001111110000000
0011111110000000
0111111110000000
1111111110000000
1111111111111111
