0000000000000000
0000000000000000
0000000000000000
0000000000000000
0000000000000000
0000000000000000
0000000000000000
0000000000110000
0000000001110000
0000000011110000
0000000111110000
0000001111111000
0000011111110000
0000111111110000
0001111111110000
1111111111111100
