0000000000000000
0000000000000000
0000000000000000
0000000000000000
0000000000000000
0000000000000000
0000000000000000
0000000000001110
0000000000000000
0000000020000000
0000000111000000
0000000000000000
0000000000000000
0000000000000000
1110000000000000
1110000000000000
