0000000000000000
0000000000000000
0000000000000000
0000000000000000
0000000000000000
0000000000000000
0000000000000000
0000111111000000
0000100000000000
0000100000000000
0003100301000000
0000111211000222
0000000000000000
0000000000000000
0000000000000000
1111111111111111
