0000000000000000
0000000000000000
0000000000000000
0000000000000001
0000000000000001
0000000000000001
0000000000000001
0000000000000000
0000000000000000
0000000000000003
0000000000000011
0000000000000011
0000000000000011
0000000000000011
1111111111111111
1111111111111111
