0000000000000000
0000000000000000
0000000000000000
0000000000000000
0000000000000000
0000000000000000
0202020000000000
0000000000000000
0000000300030000
0000000000000000
0300300011111110
1311111110000000
0000000000000000
0000000000000000
0000000000000000
0000000000000000
