0000000000000000
0000000000000000
0000000000000000
0000000000000000
1100111111111111
0000111111111111
0000111111111111
0000111111111111
0000111111111111
0000111111111111
0000011111111111
0000011111111111
1111111111111111
1111111111111111
1111111111111111
1111111111111111
