0000000000000000
0000000000000000
0000000000000000
0000000000000000
0000000000000000
0000000000000000
0000022222220000
0000000000000000
0000000000000000
0000000000000000
2200010000000000
0000000000000000
0000000000000000
0000003300000000
1111111110000000
1111111110000000
