0000000000000000
0000000000000000
0000000000000000
0000000000000000
0000000000000000
0000000000000000
1100000011111100
0000000000000000
0000000000000000
0000000000000000
0000110000000111
0000000000000000
0000000000000000
0000000000000000
1100000000000000
0000000000000000
