0000000000000000
0000000000000000
0000000000000000
0000000000000000
0011222211111111
1100000000000000
0000000000000000
0000000000000000
0000000000000000
0000000000000000
0011111000000000
0111111000000000
1111111000000000
1111111000111000
1111111000000000
1111111100000000
