0000000000000000
0000000000000000
0000000000000000
0000000000000000
1100000000000001
0000000000000000
0000000000000000
0000000000000000
0000000000000000
0000011100000000
0000000000000000
1100000000000000
0000000011101001
0000000011101001
0000000011101001
0000011111101001
