0000000000000000
0000000000000000
0000000000000000
0000000000000000
0000000000000000
0000000000000000
1000000000000000
0000000000000000
0000000000000000
0000000000000000
1110000000000000
0000000000000000
0000000000000000
0000000000000000
0011111111113313
0000000000000000
