0000000000000000
0000000000000000
0000000000000000
0000000000000000
0000000000000000
0000000000000000
0000000000000000
0000000000001003
0000000000001000
0000001000101000
0000001111101112
0000000000000000
0000000000000000
0000000000000000
1111111111111111
1111111111111111
