0000000000000000
0000000000000000
0000000000000000
0000000000000000
0000000000000000
0000000000000000
0000000000010000
0000000000000000
0000000000000000
0000000000000000
0000000020000000
0000030000001100
0000110000001100
0000110000001100
1111111011101100
1111111011101100
