0000000000000000
0000000000000000
0000000000000000
1111111111111111
0000000000000000
0000000000000000
0000000000000000
0001111111000000
0001111111001111
0001111111001111
1001111111001111
1000000000000000
1000000000110000
1000000000110000
1111111111111111
1111111111111111
