0000000000000000
0000000000000000
0000000000000000
0000000000000000
0000000000000000
0000000000000000
0000001100000000
0000031000000000
0000111000000000
0001111100000000
0011111000000000
0111111000000000
1111111000000000
1111111000000000
1111111111111110
1111111111111110
