0000000000000000
0000000000000000
0000000000000000
0000000000000000
0000000011111111
0000000011111111
0000000011111111
0000001011111111
0000000011111111
0000000011111111
0000010011111111
0000000011111111
0003000011111111
0000003011111111
0000000011111111
1111111111111111
