0000000000000000
0000000000000000
0000000000000000
0000000000000000
0000022200000000
0000022200000000
0000111100000000
0000000000000000
0000000000001110
0000000000000000
0000000000000000
0000300000000000
0001100000000000
0001100000000000
0011111111000000
0000000000000000
