0000000000000000
0000000000000000
0000000000000000
0000000000000000
0000000000000000
0000000000000000
0000000000000000
0000000000000000
0000000000000000
3000000000000000
1000000000300000
1000000000000000
1000000000000000
1000000000000000
1111111111100001
1111111111100001
