0000000000000000
0000000000000000
0000000000000000
0000000000000000
0000000000000000
0000000000000000
0000000000000000
0000000000000000
0000000000000000
0000300330000000
0001100110000000
1001100110000000
1001100110000000
1001100110000000
1001111111111111
1001111111111111
