0000000000000000
0000000000000000
0000000000000000
0000000000000000
0000000000000000
0000000000000000
0000000000000000
0000000000000000
0000000000000000
0000000000000000
0000000000000000
1311000000000000
0001000000000000
0001000111111111
0001000100000000
0001000100000000
