0000000000000000
0000000000000000
0000000000000000
1111111121111111
1110000001111111
1110000001111111
1110000001111111
0000000000000000
0000000000000000
0030011000000000
1110011000000000
0000011000000000
0000011000000033
0000011000000301
1111111110111311
1111111110111111
