0000000000000000
0000000000000000
0000000000000000
0000000000000000
0000000000000000
0000000000000000
0000000020000000
0000000030000000
0000000000030000
0000000000110000
0000000000110000
0010000000110001
0010000000110001
0010000000110001
1111111111110001
1111111111110001
