0000000000000000
0000000000000000
0000000000000000
1111111111111111
0110000110000000
0110000110000000
0110000110002222
0110000110000000
0000000110000000
0000000110000000
0000000110001111
0000000110001111
0000000000001111
0000000000001111
1001111113001111
1001111111001111
