0000000000000000
0000000000000000
0000000000000000
0000000000000000
0000000000000000
0000000000000000
1111111111000000
0000000001000000
0000000001000000
0000000001003000
0000000021011000
0000030001011000
0000110001011000
0000110001011030
0000111111111111
0000111111111111
