0000000000000000
0000000000000000
0000000000000000
0000000000000000
0000000000000000
0000000000000000
0000000001111000
0000000000110000
0000000000110000
0000000000110000
0000000000110000
1000000000110000
1000000000000000
1000000000030000
1111111111111111
1111111111111111
