0000000000000000
0000000000000000
0000000000000000
0000000000000000
0000000000000000
0000000000000000
0000000000000000
0000000000000000
0000000000000000
2220000000000000
2220000000000001
0000000000000000
0000000000000000
1111110000000000
0000010000011111
0000010000000000
