0000000000000000
0000000000000000
0000000000000000
0000000000000000
0000000000000000
0000000000000000
0000000000000000
0000000000010000
0000000000110000
0000000001110000
0000000011110000
0000000111110000
0000001111110000
0000011111110000
1111111111111111
1111111111111111
