0000000000000000
0000000000000000
0000000000000000
0000000000000000
0000000000000000
0000000000000000
0000000000000000
0000000000000000
0000000000003000
0000000000000000
0000000000000000
0000000000000000
0000000000000011
0000000000000000
0111111111100000
0100000000100000
