0000000000000000
0000000000000000
0000000000000000
0000000000000000
0000000000000000
0000000000000000
0030000000000000
0110000000000000
0110000000000000
0110000000000000
1110000000000000
0110000000000001
0110000000000001
0110000001000001
1111111111000001
1111111111000001
