0000000000000000
0000000000000000
0000000000000000
0000000000000000
0000000000000000
0000000000000000
0000000000000000
0000000000000000
0000000000000000
0000000000000000
1100000000000000
1100002222222220
1100000000000000
1100001000000000
1100001030000010
1111111111110111
