0000000000000000
0000000000000000
0000000000000000
0000000000000000
0000000000000000
0000000000000000
0000000000000000
0000000000003000
0000000000000000
0000000000000000
0000000000000000
0000030000000000
0000000000000000
0000000000000000
1111111111111111
1111111111111111
