0000000000000000
0000000000000000
0000000000000000
0000000000000000
0000000000000000
0000000011111111
0000000110000000
0000001110000000
0000011110000000
0000111110000000
0001111110000000
0011111110000000
0111111110000011
1111111110000011
1111111110000011
1111111111111111
