0000000000000000
0000000000000000
0000000000000000
0000000000000000
0000000000000000
0000000000000000
0110000000000000
0110000000000000
0110000000000000
0110000000000000
0110000000000000
0110000010000000
0000000010000000
0030000010000000
1111111111111111
1111111111111111
