0000000000000000
0000000000000000
0000000000000000
0000000000000000
0000000000000000
0000000000000000
0000000000000000
0000000000000000
0000000000000000
0000222222000000
0000000000000000
0000000000000000
0000000000000000
0000300000000000
0001100000110003
0001100000011111
