0000000000000000
0000000000000000
0000000000000000
0000000000000000
0000000000000000
0000000000000000
0000000100000000
0000000000000000
0003000000000000
0011000000000000
0011000000000000
0011000000000000
0011000000000000
0011000000000000
0011111110000000
0011111110000000
