0000000000000000
0000000000000000
0000000000000000
0000000000000000
0000300000000000
0000000000000000
1113111110000000
0000000000000000
0000000000000000
0000000000000000
3133111111100000
0000000000000000
0000000000000000
0000000000000000
0000000000111111
0000000000000000
