0000000000000000
0000000000000000
0000000000000000
0000000000000000
0000000000000000
0000000000000000
0000000000000000
0000000000000000
0000000000000000
0000000000000000
0000000000000000
2222222000000000
0000000000000000
0000000000000000
3000001000000300
1111011111111111
