0000000000000000
0000000000000000
0000000000000000
0000000000000000
0000000000000000
0000000000000000
0000000000000000
0000000000000003
0000000000000011
0000000000000011
0000000000300011
0000000001100222
0000000001100000
0000000001100000
0000000001100000
1111111111110000
