0000000000000000
0000000000000000
0000000000000000
1111111111000001
1000000011000000
1000000011000000
1000000011000000
0000000011000000
0000000011000000
0000000011000000
1000000011000000
1000000011000000
1000000000000000
1000000000000000
1113111111100001
1111111111100001
