0000000000000000
0000000000000000
0000000000000000
0000000000000000
0000000000000000
0000000000000000
2000000000001000
0000000000011000
0000000000111110
0000000001111000
0000000011111000
0000000111111000
0000001111111030
0000011111111110
0111111111111110
0111111111111110
