0000000000000000
0000000000000000
0000000000000000
0000000000000000
0000000000000000
0000000000000000
0022200000000000
0000000000000300
0000000000000000
0000000000000000
0000000000000000
0000000000000000
0000000000000000
0000000000000000
0000000000000000
0000111111111111
