0000000000000000
0000000000000000
0000000000000000
0000000000000000
0000000000000000
0030000000000022
0000011111111111
0000000000000000
0000000000000000
0000000000003000
0000000000011000
0000000000011000
0000000000011000
0000000000011000
0111111111111111
0111111111111111
