0000000000000000
0000000000000000
0000000000000000
0000000000000000
0000000000000000
0000000000003000
1100000000000000
0100000030000000
0100000000000000
0100300000000000
2101100000000000
0101100000000000
0101100000000000
0101103000000000
1111111111111100
1111111111111100
