0000000000000000
0000000000000000
0000000000000000
0000000000000000
0000000000000000
0000000000000000
0000001110000000
0000000000000000
0000000000111111
0000000001111111
0000000011110000
0000000111110000
0000001111110000
0000011111100001
0000011111100001
0000011111100001
