0000000000000000
0000000000000000
0000000000000000
0000000000000000
0000000000000000
0000000000000000
0000000000300000
0000000001100000
0000000001100000
0030000001100000
0000000011100000
0000000001100000
0000000001100000
0000000001100000
1111111111111111
1111111111111111
