0000000000000000
0000000000000000
0000000000000000
0000000000000000
0000000000000000
0000000000000000
0000000001100000
0000000011100000
0000000111100000
0000001111100000
0000011111100000
0000111111100000
0001111111100000
0011111111100000
1111111111111111
1111111111111111
