0000000000000000
0000000000000000
0000000000000000
0000000000000000
0000000000000000
0000000003000000
0000001111111111
0000000000000000
0000000000000000
0000000000030000
0000001111112111
0000000000000000
0000000000000000
0000000000000000
1111111111111111
1111111111111111
