0000000000000000
0000000000000000
0000000000000000
0000000000000000
0000000000000000
0000000000000000
0030000000000000
1111110000000000
0000000000000000
0000000000000000
0030000001000000
0022222221000000
0000000000000000
0000000000000000
0033000000000000
1111111111111111
