0000000000000000
0000000000000000
0000000000000000
0000000000000200
0000000000000000
0000000000000000
0000000000001000
0000000000000000
0000000000000000
0000000000000000
0000000011111110
0000000000000000
0000000000000000
0001100000000000
0001100000000000
0001100000000000
