0000000000000000
0000000000000000
0000000000000000
0000000000000000
0000000000000000
0000000000000000
0000000000303030
0000000001111110
0000000001111110
0000022002222220
0000000000000000
0000000000000000
0000000000000000
0000000000000000
1111111001111111
1111111001111111
