0000000000000000
0000000000000000
0000000000000000
0000000000000000
0000000000000000
0000000000000000
0000000000000000
0000000000000000
0000000000000000
0000000000300000
0000000000000000
0000002200000000
0000002200000000
0000000000000000
1111111111111111
1111111111111111
