0000000000000000
0000000000000000
0000000000000000
0000000000000000
0000000000000000
0000000000000000
0000000000000000
0000000000000000
0000000000000000
0000000000222200
0000000000222200
1000110000000000
0000000000000000
0000000011111110
0000000010000000
0000000010000000
