0000000000000000
0000000000000000
0000000000000000
0000000000000000
1111111111111112
0000000000000000
0000000000000000
0000000000000000
0000000000000000
0000000000000000
0000000000011111
0000000000111111
0000000001111111
0000000011111111
1000001111111111
1000001111111111
