0000000000000000
0000000000000000
0000000000000000
0000000000000000
0000000000112222
0000000011000000
0000011100000000
0000000000000000
0000000000000000
0000100000000000
0030000000111110
0110000001111110
0110000011111110
0110000111111110
0110001111111110
1111111111111111
