0000000000000000
0000000000000000
0000000000000000
0000000000000000
0000000000000000
0000000000000000
0000000000000000
0000000000000000
0000000000000000
0000000000000002
0000001110000001
0000030000000000
0000110000000000
0000110000000000
0000110000000000
0000110000000000
