0000000000000000
0000000000000000
0000000000000000
0000000000001111
0000000000000110
0000000000000110
0000000000000110
0000000000000110
0000000000000110
0000000000000110
2222222222200110
0000000000000000
0000000000000000
0000000000000000
1331111131311111
1111111111111111
