0000000000000000
0000000000000000
0000000000000000
0000000000000000
0000000000000000
0000000000000000
3000000000000000
0000000000000000
0000000000000000
0000000000000000
0000000002220000
0000000000000000
0000010000000000
0000010303000000
0111111111111111
0111111111111111
