0000000000000000
0000000000000000
0000000000000000
0000000000000000
0000000000000000
0000000000000000
0000000000000000
0000000000000031
0000000000000311
0000000000003111
1110000001001111
0000000000011111
0000000000111111
0000000001111111
0000000011111111
0000000111111111
