0000000000000000
0000000000000000
0000000000000000
0000000000000000
0000000000000000
0000000000000000
0000000000000000
0000000000110000
0000000001110000
0000000011110000
0000000111110000
0000001111110000
0000001111110000
0000001111110000
1000001111110000
1000001111110000
