0000000000000000
0000000000000000
0000000000000000
0000000000000000
0000000000000000
0000000000000000
1111111000000000
0000000000000000
0000000000000000
0000000000000000
0011111000000222
1100000000000000
1100000000000003
1100000000000000
1111111111111111
1111111111111111
