0000000000000000
0000000000000000
0000000000000000
0000000110000000
0000000110000000
0000000110000000
0000000110000000
0000000000000000
0000000030000000
0000000300000000
0000001100022222
0000001100000000
0000001100000000
0000001100000000
1111111111111111
1111111111111111
