0000000000000000
0000000000000000
0000000000000000
0000111100000000
0000011000000000
0000011000000000
0000011000000000
0000011000000000
0000011000000000
0000011000000000
2220011000000010
0000000000000010
0000000000300010
0000000000000310
3131111111111110
1111111111111110
