0000000000000000
0000000000000000
0000000000000000
0000000000000000
0011111111111111
0011110000000000
0011110000000000
0011110000000000
0000000000000000
0000000000000000
0002000000000000
0012110000000001
0011100000000000
0011000000000000
0000303300010000
1111011111110000
