0000000000000000
0000000000000000
0000000000000000
0000000000000000
0000000000000000
0000000000300000
2222000000000111
0000000000000000
0000000000000000
0000000000000000
0000000000000000
0000000000000000
0000000000000000
0000000000000000
1000000001111111
1000000001111111
