0000000000000000
0000000000000000
0000000000000000
0000000000000000
0000000000000000
0000000000000000
0000000111111110
0000000000000000
0000000000000000
0000000000000000
0000000000111110
0000000011000000
0000000011000000
0110000011000000
0111111111111111
0111111111111111
