0000000000000000
0000000000000000
0000000000000000
1111000000000000
0110000000000000
0110000000003000
0110000000011000
0000000000111000
0030000001111000
0000000031111000
0000000111111000
0000301111111000
0001111111111000
0001111111111000
0001111111111111
0001111111111111
