0000000000000000
0000000000000000
0000000000000000
0110000111111111
0110000001100001
0110000001100001
0110000001100001
0110000001100001
0110000000000001
0110000000000001
0111000000000001
0110000000000001
0110000000000000
0110000000000000
0111111110011111
0111111110011111
