0000000000000000
0000000000000000
0000000000000000
0000000000000000
0000000000000000
0000000000000000
1110000000001000
1000000000000000
1000000000000000
1000000000300000
1000000001100000
0000000001100000
3000000001100000
0000000001100000
1111113111100000
1111111111100000
