0000000000000000
0000000000000000
0000000000000000
0000000000000000
0000000000000000
0000000000000000
0000000000000000
0000000000000000
0000000000000000
0000000000000000
0222000000000000
0000000000100000
0000000000100000
0300000000100000
1111111111111111
1111111111111111
