0000000000000000
0000000000000000
0000000000000000
0000000000000000
0000000000000000
0000000222220000
0000001111111000
0000000000000000
0000000000000000
0000000000000000
1110000000000000
0000000000000000
0000000000000000
0000000000000000
0000000000000000
0000000000000000
