0000000000000000
0000000000000000
0000000000000000
0000000000000000
0000000000000000
0000000000000000
0000000000000300
0000030111110000
0030000000000000
0000000000000000
0000000000000000
0000000011100000
0000000000000000
0000000000000000
0000000000000000
0000001111111111
