0000000000000000
0000000000000000
0000000000000000
0000000000000000
1111111111111111
1000000000000000
1000000000000000
1000030000000000
0000110000000000
0000110000000000
0000110000000000
0002111003000000
0000000011000000
0000000011000110
0000000011000110
1110000111000110
