0000000000000000
0000000000000000
0000000000000000
1111111111111111
0000000001111111
0000000001111111
0000000001111111
0000000000000000
0000000000000000
0022222220000000
1122222221111111
1111111110000000
1111111110000000
0000000000000000
1011111111111111
1011111111111111
