0000000000000000
0000000000000000
0000000000000000
0000000000000000
0000000000000000
0000000000000000
0000000000000000
0000000000000000
0000000000000000
0000000000000003
0000000000000000
0000000000000000
0000000000000000
0000000000000000
0003000003300000
1111111111111110
