0000000000000000
0000000000000000
0000000000000000
0000000000000000
0000000000000000
0000000000000000
0000000000000000
0000000000000000
0000000000000000
0000000300000000
0000000011100000
0000000000000000
0000000000000000
0000000000000000
0330000000000000
1111111000000001
