0000000000000000
0000000000000000
0000000000000000
0000000000000000
1000001111111111
1000000000000000
1000000000000000
1000000000000000
1000000000000000
1000000000000000
1000000000000000
1000000000000000
1000000000000003
1000000000000000
1000000000000000
1111111111111111
