0000000000000000
0000000000000000
0000000000000000
0000000000000000
0000000000000000
0000000000000000
0000000000000000
0000000000000000
0000000000000000
0000000222200002
0000000222200002
0000000300000000
0000000000000000
3111111111113111
0000010000000000
0000010000000000
