0000000000000000
0000000000000000
0000000000000000
0000000000000000
1111100000000000
1111100000000000
1111100000000111
1111100000000000
1111100000000000
1111100000001000
1111100000300000
0001100001100000
0001100001100000
0001100001100001
0003300001100011
1111111111111111
