0000000000000000
0000000000000000
0000000000000000
0000000000000000
0000000000000000
0000000000000000
2220000000000000
2220000000000000
0000000000000000
0000000000000000
0000000000000000
0001111113110000
0001000000010000
0001000000010001
0001000000010001
0001000000010001
