0000000000000000
0000000000000000
0000000000000000
0000000000000000
0000000000000000
0000000000000000
0000000000000000
0000000000000000
0000000000003000
0000000000000000
0000000000010001
0000000000000000
0101000000000000
0101000000000000
1111000000000000
1111000000000000
