0000000000000000
0000000000000000
0000000000000000
0000000000000000
0000000000000000
0000000000000000
0000030001100000
0030030001100000
0000000001100000
0000000001100000
0000000001100000
0000000001100000
0000000000000000
0000000000300000
0000000011111111
0010000011111111
