0000000000000000
0000000000000000
0000000000000000
0000000000000000
0000000000000000
0000000000000000
0000000000000001
0001110000000000
0000000000000000
0002020000000000
0002020111000000
0000000000000000
0000000000000000
0000000000000000
0000000000011311
0000000000000000
