0000000000000000
0000000000000000
0000000000000000
0000000000000000
0000000000000000
0000002220000000
1111111110000111
0000000000000000
0000000000000000
0000300000000000
0001100000010000
0001100000000000
0001100000000000
0001100000000000
1111111111000000
1111111111000000
