0000000000000000
0000000000000000
0000000000000000
0000000000000000
0000000000000000
0000000000000000
0000000000000000
0000000000000000
0000000000000000
0000000000000000
0002222000000000
0000000000003000
0000000000000000
0000000000000000
0033000000000000
1111111111111111
