0000000000000000
0000000000000000
0000000000000000
0001000000000000
0000000000000000
0000000000000000
0111100000000000
0111000000000000
0000000000000000
0000000000000000
0000000000000000
0000000000000300
0000000000000000
1100000000000000
1111111111111111
1111111111111111
