0000000000000000
0000000000000000
0000000000000000
0000000000000000
0000000000000000
0000000000000000
0000000000000000
0000100310000000
0000100010000000
0010100010000000
1110111210000000
0000000000000000
0000000000000000
0000000000000000
1111111111111100
1111111111111100
