0000000000000000
0000000000000000
0000000000000000
0000000000000000
0000000000000000
0000000000000000
0000100003000000
0000000011000000
0000000011000000
0030000011000000
0110000011000000
0110000011000000
0110000011000000
0110000011000000
1110000011111111
1110000011111111
