0000000000000000
0000000000000000
0000000000000000
0000000000000000
1111110000000000
1111110000000000
1111110000000000
1111110000000000
1111110000000000
1111110000000000
1111110000000000
1111110000000000
1111110000000000
1111110000000000
1111110000000000
1111110011111111
