0000000000000000
0000000000000000
0000000000000000
0000000000000000
0000000000000000
0000000000000000
0000000000000000
1110000000001100
1110000000001100
1110000000001100
1110000000001100
1110000000001100
1110000000001100
1110000000001100
1110000000001100
1110000000001111
