0000000000000000
0000000000000000
0000000000000000
0000000000000000
0000000000000000
0000000000022220
0011100000111111
0000000000000000
0000000000000000
0000000000000000
0011100000000000
0000000000000000
0000000000000000
0000000000000000
0000000000000000
0000000000000000
