0000000000000000
0000000000000000
0000000000000000
0000000000000000
0000000000000000
0000000000000000
0011000001110000
0000000000000000
2222222000000000
2222222000000000
0000003000000000
0000011000000000
3000011000000000
1000011000000000
1000011000000000
1000011000000000
