0000000000000000
0000000000000000
0000000000000000
0000000000000000
0000000000000000
0000000000000000
0000111110000011
0001000000000001
0011000000000001
0111000000020001
1111000000000001
0000000000000000
0000000000000000
1000000000000100
1111111111111101
1111111111111101
