0000000000000000
0000000000000000
0000000000000000
0000000000000000
0000000000000000
0000000000000000
0000000000000000
0000002222000000
0000000000000000
0000000000003000
0000000000000000
1110000000000000
0000011001100110
0000000000000000
0000000000000000
0000000000000000
