0000000000000000
0000000000000000
0000000000000000
0000000000000000
0000000000000000
0000000000000000
0000000000000000
1100000000000000
0000000000000000
0000000000000000
0100000000000000
1100022222000000
0000000000000000
0000000000000000
0000000000003000
1111111111111111
