0000000000000000
0000000000000000
0000000000000000
0000000000000000
0000000000000000
0000000000000000
0000000000000000
0000030003000000
0000000000000000
0000000000000000
0000000000000000
0000000000000010
0000000000000000
0000000000000000
0000000000000000
1111111111000000
