0000000000000000
0000000000000000
0000000000000000
0000000000000000
0000000000000000
0000000000000000
0000000000000000
0000000000000000
0000000000000000
0000000000000000
0000000000000000
2222220000000000
0000000000000000
0000000000010000
1111111111110000
1111111111110000
