0000000000000000
0000000000000000
0000000000000000
0000000000000000
0000000000000000
0000300000000000
0000000030000000
3000000000000000
0000000000000000
0000000000000000
0000000000000000
0000000000000000
0000000000000100
0000000000000103
1111110001111111
1111110001111111
