0000000000000000
0000000000000000
0000000000000000
0000001111111111
0000000000000000
0000000000000000
0000000000000000
0001000000000000
0000000000000000
0000000000000000
0000000000000000
0000000000000000
0000002222222200
0000002222222200
0000001111111100
0001001111111100
