0000000000000000
0000000000000000
0000000000000000
0000000000000000
0000000000000000
0000000000000000
1100200000000000
0000200000000000
0000001110000000
0000000000000000
0000000000000000
0000000000000000
0011100000000000
0000000000000000
0000000000011111
0000000000000000
