0000000000000000
0000000000000000
0000000000000000
0000000000000000
0000000000000000
0000000000000000
0000000000000011
0000000000000000
0000000000000000
0000000000000000
0000000000011111
0000000000000000
0000000011100000
0000000000000000
1111111111100000
0000000000000000
