0000000000000000
0000000000000000
0000000000000000
0000000000000000
0000000000000000
0000000000000000
0000000000000000
0000000000000000
0000000000000000
0000000000000000
0000000000000000
3000000000001110
0000000000000000
1111111000000000
0000001000000000
0000001000000000
