0000000000000000
0000000000000000
0000000000000000
0000000000000000
0000000000000000
0000000000000000
0000000000000000
0000000000000110
0000000000001110
0000000000011110
0000000000111110
0000000001111110
0000000011111110
0000000111111110
0000301111111110
1111111111111111
