0000000000000000
0000000000000000
0000000000000000
0000000000000000
0000000000000000
0000000000000000
0000000022200000
0000000022200000
0000000000000000
0000000000000000
0000000000000000
0000030000011111
0000000000010000
1111111000010000
0000001000010000
0000001000010000
