0000000000000000
0000000000000000
0000000000000000
0000000000000000
0000000000000000
0000000000000000
0000000000000222
0000000000011111
0000000000000000
0000000000000000
0000000000000000
0000000000000211
0000000000000000
0000000000000000
0303000000000000
1111111100011111
