0000000000000000
0000000000000000
0000000000000000
1111111111111111
0000000000000000
0000000000000000
0000000000000000
0000000000000000
1000000000000000
1000200000222222
1211211111222222
0000111111111111
0000111111111111
0000000000000000
1111110110111111
1111110110111111
