0000000000000000
0000000000000000
0000000000000000
0000000000000000
0000000000000000
0000000000000000
0000030000000000
1111000000000000
0000000000000000
0000000000000000
0000000000000000
1110000000000000
0000000000000000
0000000000000000
0000000000000000
1111111111111111
