0000000000000000
0000000000000000
0000000000000000
0000000000000000
0000000000000000
0002222000000000
0011111130000000
0000000000000000
0000000000000000
0000000000000000
0000000000000000
0000000000000000
0000000000000000
0000000001111311
0000000000000000
0000000000000000
