0000000000000000
0000000000000000
0000000000000000
0000000000000000
0000000000000000
0000000000000000
0000000000300000
0111111111111100
0000000000000000
0000000000000000
0000000000300000
0000000000222222
0000000000000000
0000000000000000
0000001000330000
0000001111111111
