0000000000000000
0000000000000000
0000000000000000
0000000000000000
0000000000000000
0000000000000000
0000000000000000
0000000000001111
0000000000001000
0000000000001000
0000000000031003
0000000000001112
0000000000000000
0000000000000000
0000000000000000
1111111111111111
