0000000000000000
0000000000000000
0000000000000000
0000000000000000
0000000000000000
0000000000000000
0222220000011100
1111111000000000
0000000000000000
0000000000000000
0000000000000000
0000000000000000
0000000000000000
0000000000000000
0000000300000000
1111111111100000
