0000000000000000
0000000000000000
0000000000000000
2111111111111111
0111111111111111
0111111111111111
0111111111111111
0000000000000000
0000000000000000
0000000000000000
0000000000000111
0000000001110111
0000003311110111
0000030111110111
1011131111110111
1011111111110111
