0000000000000000
0000000000000000
0000000000000000
0000000000000000
0000000000000000
0000000000000000
0000000000000001
0000000000000011
0000000000000111
0000000000001111
0000000000011111
0000030000111111
3000110001111111
1000110011111111
1000110111111111
1000111111111111
