0000000000000000
0000000000000000
0000000000000000
0000000000000000
0000000000000000
0000000000000000
0000000000000011
0000000000000310
0000000000001110
0030000000011111
0110000000111110
0110000001111110
0110000011111110
0110000111111110
1111101111111111
1111101111111111
