0000000000000000
0000000000000000
0000000000000000
0000000000000000
0000000000000000
0000000000000000
0000000000000000
1000111101111111
0300000000000000
0000000000000000
0000000000000000
0012000000000000
0110000000000000
1110000000000000
1110000000000010
1111111000000011
