0000000000000000
0000000000000000
0000000000000000
0000000000000000
0000000000000000
0000000000000000
0003000000000000
1111111110000000
0000000000000000
0000000000000000
0000000000000001
0000000111111111
0010000000000000
0010000000000000
0010000000000000
1111111111111111
