0000000000000000
0000000000000000
0000000000000000
0000000000000000
0000000000000000
0000000000000000
0000000011000010
0000000000000000
0000000000000000
0000000222200000
1000000111100000
0000000000000000
0000000000000000
0000000000000001
0000000000000001
0000000000000001
