0000000000000000
0000000000000000
0000000000000000
0000000000000000
0000000000000000
0000000000000000
0000100000000000
0001100001100000
0011111000000000
0111100000000000
1111100000000000
1111100000000000
1111103000000000
1111111000000000
1111111000000000
1111111000000000
