0000000000000000
0000000000000000
0000000000000000
0000000000000000
0000000000000000
0000000000000000
0000000000000000
0000000000000000
0000000010000000
0000000000000000
0000000000000000
0000000000000000
0000000000000000
0000000010000000
0000100010000000
1111100010011111
