0000000000000000
0000000000000000
0000000000000000
0000000000000000
0000000000000000
0000000000000000
0000000000000000
0000000000000000
0000000000000000
2220000222200000
2220000222200000
0000000000000000
0000000000000000
1111311111111100
0000000000000100
0000000000000100
