0000000000000000
0000000000000000
0000000000000000
0000000000000000
0000000000000000
0000000000000000
0000020200000000
1110000000000000
0000000000000000
0000000000000000
0000000000000000
0000011100000000
0000000000000000
0000000000000000
0000000000000000
0000000000011111
