0000000000000000
0000000000000000
0000000000000000
0000000000000000
0000000000000000
0000000000000000
0000000000000000
0000000000000000
0000000000000000
0002222000000000
0002222000000000
0000000000000300
0000000000000000
1111111111111110
1000000000000010
1000000000000010
