0000000000000000
0000000000000000
0000000000000000
0000000000000000
0000000000000000
0000000000000000
0300000000000000
1100000000000000
1100000000000000
1100000000000000
1100000000000020
1100000000000000
1100000000000000
1100000030000000
1111111111111110
1111111111111110
