0000000000000000
0000000000000000
0000000000000000
0000000000000000
0000000000000000
0000000000000000
1111110002000000
0000000000000000
0000000000000000
0000000000000000
0000011131000001
0000000000000000
0000000000000000
0000000000000000
0000000000000000
0000000000000000
