0000000000000000
0000000000000000
0000000000000000
0000000000000000
0000000000000000
0000000000000000
0000000000000000
1000000000000000
0000000000000000
0000000000000000
0000000100000000
1111111100000000
0000000000000000
0000000000000000
0000000000000030
1111111111111111
