0000000000000000
0000000000000000
0000000000000000
0000000000000000
1111100000000000
1111100000000000
1111100000000000
1111100000000000
1111100000000000
1111100000000000
1111100000000000
1111100000000300
1111100030001100
1111100110001100
1111100110001101
1111100110001111
