0000000000000000
0000000000000000
0000000000000000
0000000000000000
0000000000000000
0000000000000000
0000000000001110
0000000000000000
0000001110000000
2022000000000000
1131100000000000
0000000000000000
0000000000000000
0000000000000000
0000000000000000
0000000000000000
