0000000000000000
0000000000000000
0000000000000000
0000000000000000
0000000000000000
0000000000000000
0000000000000000
0000000000000000
0000000000000030
0000000000000000
0000000000000003
0000000000000011
0000000000000011
0000000000000011
0000003303000011
1111111111111111
