0000000000000000
0000000000000000
0000000000000000
0000000000000000
0000000000000000
0000000000000000
0000000000000000
0000000000000000
0000000000000000
0000030000000000
0000000000000000
0000000000000000
1111111100000000
0000000100000000
0000000101111111
0000000101000000
