0000000000000000
0000000000000000
0000000000000000
0000000000000000
0000000000000000
0000000000000000
0000000000000000
0110000000000000
0000000000000000
0000000000000000
0000000000001100
0000000000011100
0000000000111100
0000000001111100
0000000001111111
0000000001111111
