0000000000000000
0000000000000000
0000000000000000
0000000000000000
0000000000000000
0000000000000000
0000000000000001
0000300000000013
0000000000000311
0000000000003111
0000000000011111
0000000000111111
0000000001111111
0000000011111111
1111111111111111
1111111111111111
