0000000000000000
0000000000000000
0000000000000000
0000000000000000
0000000000300000
0000000001100000
0000000001100000
0000100001100000
0000000000000000
0000000000000000
0000010000000000
0000000000000000
0000000000000000
0000000000000000
0003000000000000
1111111000000000
