0000000000000000
0000000000000000
0000000000000000
1100000111111111
1100000000000000
1100000000000000
1100000000000000
1100000001111111
1100000001111111
1100000001111110
1100000021111100
1100000000000000
0000000000000000
0000000000000000
1110000111111111
1110000111111111
