0000000000000000
0000000000000000
0000000000000000
0000000000000000
0000000000003000
0000000000000000
0000001111131111
0000000000000000
0000000000000000
0000000000000000
0001111131331111
0000000000000000
1110000000000000
0000000000000000
1110000000000000
0000000000000000
