0000000000000000
0000000000000000
0000000000000000
0000000200000000
0000000000000000
0000000000000000
0000001111002000
0000000000002000
0000000000000011
0000000000000000
0000000000000000
0000000000000000
0000000000111000
0000000000000000
0113100000000000
0000000000000000
