0000000000000000
0000000000000000
0000000000000000
0000000000000000
0000000000000000
0000000000000000
0000000000000000
0000000000000000
0000000000000000
0103300001000000
0111111111000000
0000000000000000
0000000000000000
0000000000000000
1111111111113313
1111111111111111
