0000000000000000
0000000000000000
0000000000000000
0000000000000000
0000000000000000
0000000000000000
0000000000000000
0002200000000000
0000000000000000
0000000000000000
0022000000000000
0000000000000000
0000000000000000
0000000000030000
0111111111111111
0100000000000000
