0000000000000000
0000000000000000
0000000000000000
0000000000000000
0000000000000000
0000000000000000
0000000000000000
0000000000000000
0000000000000000
0000000000000000
0003000000000000
0000000300000000
0000001100000000
0000001100000000
0000001100030000
1111111111111111
