0000000000000000
0000000000000000
0000000000000000
0000000000000000
0000000000000000
0000000000000000
0000000000000000
0000000000000000
0000000000000000
0000000000000000
0000000000000000
0022200000000000
0000000000000000
0000000000000000
0000000000000330
1111100111111111
