0000000000000000
0000000000000000
0000000000000000
0000000000000000
1000011111111111
0000011110000000
0000011110000000
0000011110000300
0000000000001100
0000000000001100
0000000300001100
0000001100021110
0000001100000000
0000001100000000
0000001100000000
0111111111100001
