0000000000000000
0000000000000000
0000000000000000
0000000000000000
0000000000000000
0000000000000000
0000000000000000
0000000000000010
0000000000000000
0000000000000000
0000000000000100
0000000000000000
0000000000030000
0000000000000030
0000000000000000
1111111111111111
