0000000000000000
0000000000000000
0000000000000000
0000000000000000
0000000000000000
0000000000000000
0000000000000000
0000000000000000
0000000000000000
0000000000000000
0220000000000000
0000000000000000
0000010000000300
0000010000001100
0000010000001100
1111111111111100
