0000000000000000
0000000000000000
0000000000000000
0000000000000000
0000000000000000
0000000000000000
0000000111000000
0000001311000000
0000031111000000
0000311111000000
0001111111000000
0011111111000000
0111111111000000
1111111111000000
1111111111111111
1111111111111111
