0000000000000000
0000000000000000
0000000000000000
0000000000000000
0000000000000000
0000000000000000
0000000000000000
0000000000000000
0000000000000000
0000000222000000
0000000222000000
0000000000000000
0000000000000000
0000000000000000
1111111111113313
1111111111111111
