0000000000000000
0000000000000000
0000000000000000
0000000000000000
1111111111111111
0000000000000000
0000000000000000
0000000000000000
0000000000000000
0000000000000000
0000000000111000
0011100000000000
0000000000000000
0000000000000000
0000000000000000
0000000000000000
