0000000000000000
0000000000000000
0000000000000000
0000000000000000
0000000000000000
0000000000000000
0000000000000000
0000110000000000
0000110000000000
0000110000000000
0000110000000000
0000110000000000
0000110000000000
0000110000000000
0000110000000000
0000111111111000
