0000000000000000
0000000000000000
0000000000000000
0000000000000000
0000000000000000
0000000000000000
0000000000000003
0000000000000000
0000000000000000
0022220000000001
0022220000000000
0000000011100000
0000000000000000
1111111000000000
1000000000000000
1000000000000000
