0000000000000000
0000000000000000
0000000000000000
0000000000000000
0000000000000000
0000000000000000
0000000000000000
0000000011111100
0000003000000000
0000000000000000
0000000300000000
0000001100011000
0000001100011000
0000001100011000
0300001100011000
1111111100011001
