0000000000000000
0000000000000000
0000000000000000
0000000000000000
0000000000000000
0000000000000000
0000000000000011
0000000000000011
0000000000000011
0000000000000011
0000000000000011
0000000100000000
0000000110000003
0100000111100000
1100000111111111
1100000111111111
