0000000000000000
0000000000000000
0000000000000000
1111111111111111
0111111111111111
0111111111111111
0111111111111111
0000000000000000
0000000000000000
2000000000000000
2111111111111200
1000000000000000
1000000000000001
0000000000000001
1111111111111111
1111111111111111
