0000000000000000
0000000000000000
0000000000000000
0000000000000000
0000000000000000
0000000000000000
0000000000000001
0000000000000000
0000000000030000
0000000000110000
0000002000110000
0000000000110000
0000000000110000
3000000000110000
1111111000111111
1111111000111111
