0000000000000000
0000000000000000
0000000000000000
0000000000000000
0000000000000000
0000000000000000
0000000000000000
2000000000001000
0000000000000000
0000000000000000
2000000000000100
1000000000000000
0000000000000000
0100001100000000
0100001100030000
1100001111111110
