0000000000000000
0000000000000000
0000000000000000
0000000000000000
1111111110000111
0000000000000111
0000000000000111
0000000000000111
0000000000000000
0000000000000000
0011100000000003
0000000000000011
0000000000000011
0000000000000011
0000000000000011
0000000001111111
