0000000000000000
0000000000000000
0000000000000000
0000000000000000
0000000000000000
0000000000000000
0000000002020200
0000000000000000
0000000000000003
0000000000000000
0000030003003000
1111111113111111
0000000000000000
0000000000000000
0000000000000000
0000000000000000
