0000000000000000
0000000000000000
0000000000000000
0000000000000000
0000000000000000
0000000000000000
0000000000000000
0000000000000000
0000000000000000
0000000000000300
0000000000000000
0000000000000000
0000111111111111
0000100000000001
1000100000000001
0000100000000001
