0000000000000000
0000000000000000
0000000000000000
0000000000000000
0000000000000000
0000000000000000
0000000000000000
0000000000000000
0002222000000000
0000000000000000
0000000000000000
0000000000000000
0000000000000000
0000000000000000
0000000003033000
1111111111111111
