0000000000000000
0000000000000000
0000000000000000
1111111111111111
0000000000000000
3000000000000000
2200000000000000
0000000000011111
0000000000011111
0000000000011111
1111111110011111
1111111110000000
1111111110000000
1111111110000000
1111111111111111
1111111111111111
