0000000000000000
0000000000000000
0000000000000000
0000000000000000
0000000000000000
0000000000000000
0000000000001111
0000000000010000
0000000000110000
0000000001110000
0000000011110000
0000000000000000
0300000000000000
3000000010000000
1111111111111111
1111111111111111
