0000000000000000
0000000000000000
0000000000000000
0000000000000000
0000000000000000
0000000000000000
0000000000000000
0000000000000000
0000000000000000
0000000000000000
0000000002200000
0000000000000000
0000000000000100
0100000000000100
0100003300000100
0111111111111111
