0000000000000000
0000000000000000
0000000000000000
0000000000000000
0000000000000000
0000000000000000
2222200300000000
1111111110001111
0000000003000000
0000000000000000
0000000000000000
1111111100120000
0000000001100000
0000000011100000
0003000111100000
1111111111111110
