0000000000000000
0000000000000000
0000000000000000
0000000000000000
0000000000000000
0000000000000000
2222222220000000
0000001100000000
0000001100000000
0000001100000000
1111101100000000
0000000000000001
0000000300000011
0000000300000111
1111111101111111
1111111101111111
