0000000000000000
0000000000000000
0000000000000000
0000000000000000
0000000000000000
0000000000000000
0000000000000000
0000000000000000
0000300000000000
0000000000000000
0001000100000000
0000000000000000
0000000000000000
0000000000000000
0000000001111111
0000000001111111
