0000000000000000
0000000000000000
0000000000000000
1111111111111111
0000000000000000
0000000000000000
0000000000000000
0000000000000000
0000000000000000
0000000000000000
0000000001100000
0000000001100001
2222220001100001
2222220001100001
1111110001100001
1111110001100001
