0000000000000000
0000000000000000
0000000000000000
0000000000000000
1111111211111111
0000000000000000
0000000000000000
0000000000000000
0000000000000000
0000000000000000
0001111100000300
0011111100001100
0111111100001100
1111111100001100
1111111100001100
1111111100111111
