0000000000000000
0000000000000000
0000000000000000
0000000000030000
0000000000110000
0000000000110000
0000000011111000
0000000000000000
0000000000000011
0000000000000000
0013111000000000
0000000000000000
0000000000000000
0000000000000000
1100000000000000
0000000000000000
