0000000000000000
0000000000000000
0000000000000000
0000000000000000
0000000000000000
0000000000000000
0000000000000000
0000000000000022
0000000000000000
0000000000000000
0000000000000000
0000111111100000
0000000000000110
0000000000000000
0000000000000000
1110000000000000
