0000000000000000
0000000000000000
0000000000000000
0000000000000000
0000000000000000
0000000000000000
0000000000000000
0000000000000000
0000000000000000
0000000000000000
0100000000000000
2100000000000000
0000000000000000
0000000000000000
0000000003300000
1111111100111111
