0000000000000000
0000000000000000
0000000000000000
0000000000000000
0000000000000000
0000000000000000
0000000000000000
0011000000001110
0111000000001110
1111000000001110
1111000000001110
1111100000001110
1111000000001110
1111000000001110
1111000000001110
1111110000001110
