00000000000000000000000000000000000000000000000000000000000000000000000000000000000000000000000000000000000000000000000000000000000000000000000000000000000000000000000000000000000000000000000000000000000000000
00000000000000000000000000000000000000000000000000000000000000000000000000000000000000000000000000000000000000000000000000000000000000000000000000000000000000000000000000000000000000000000000000000000000000000
00000000000000011000000000000000000011110000000000000000000000000000000000000000000000000000000000000000000000000000000000000000000000000000000000000000000000000000000000000000000000000000000000000000000000000
00000000000000011000000000000000000001100000000000000000000000000000000000000000000000000000000000000000000000000000000000000000000000000000000000000000000000000000000000000000000000000000000000000000000000000
00000000000000011000000000000000000001100000000000000000000000000000000000000000000000000000000000000000000000000000000000000000000000000000000000000000000000000000000000000000000000000000000000000000000000000
00000000000000011000000000000000000001100000000000000000000000000000000000000300011000000000000001111000000000000000000000000000000000000000000000001111100000111110000000001000030000000000000000000001000000000
00000000000000000000000000000000000001100000000000000000000000000000000000300300011000000000000000110000000000000000000000000000000000000000000000010000000000011000000000000000110000000000000000000000000000000
00000000000000003000000000000000000001100000000000000000000000000000000000000000011000000000000000110000000000000000000000003000000000000000000000110000000000011000000000000000110000000000000000030000000000000
00000000000000030000000000000000000001100000000000000000000000000000000300000000011000000000000000110000000000000000000000000000000000000000000001110000000200011000000000300000110000000000000000110000000000000
00000000000000110002222222222222222001100000001000000000000000000000000000000000011000000000000000110000000000000000000000010001000000000000000011110000000000011000000001100000110000000000002000110000000000000
00000000000000110000000000000000000000000000001000000000000000000000000000000000011000001000000000110000000000030000000000000000000000000000000000000000000000000000000001100000110000000000000000110000000000000
00000000000000110000000000000000000000000030001000000000000000000000000000000000000000001000000000000000000000110101000000000000000000000300000000000000000000003000000001100000110000000000000000110000000000000
00000000000000110000000000000000000000000000031000000000000000000010000000000000003000001000000000030000000000110101000000000000000000003000000010000000000001000000000001100000110000003000000000110000000000001
11111111111111111111111113311111313111111111111000001131111111111110000000000000111111111111111111111111311111111111000000000000011111111111111111111111111111011111113111100000111111111111111000111111100000001
11111111111111111111111111111111111111111111111000001111111111111110000000100000111111111111111111111111111111111111000000000000011111111111111111111111111111011111111111100000111111111111111000111111100000001
