0000000000000000000000000000000000000000000000000000000000000000000000000000000000000000000000000000000000000000000000000000000000000000000000000000000000000000000000000000000000000000000000000
0000000000000000000000000000000000000000000000000000000000000000000000000000000000000000000000000000000000000000000000000000000000000000000000000000000000000000000000000000000000000000000000000
0000000000000000000000000000000000000000000000000000000000000000000000000000000000000000000000000000000000000000000000000000000000000000000000000000000000000000000000000000000000000000000000000
0000000000000000000000000000000000000000000000000000000000000000000000000000000000000000000000000000000000000000000000000000000000000000000000000000000000000000000000000000000000000000000000000
0000000000000000000000000000000000000000000000000000000000000000000000000000000000000000000000000000000000000000000000000000000000000000000000000000000000000000000000000000000000000000000000000
0000000000000000000000000000000000000000000000000000000000000000000000000000000000000000000000000000000000000000000000000000000000000000000000000030303000000000000100000000000000000011000000000
0000000000000000000000000000000000000000000000000000000000000000000000000000000000000000000000000001000000000000000000000000000000000000000000000111111000000000000000000000000000000310000000000
0000000000000000000000000000000000000000000000000000000000000000000000000000000000000000000000000011000000000000000000003000000000000000000000000111111000000000000000000000000000001110000000000
0000000000000000000000000000100000000000000000000000000000000000000000000000000000000000000000000111000000000000000000011000000000000000000002200222222000000000000000000030000000011111000000000
0000000000000000000000000000000000000000000000110000000000000000000000000000000000000000000000001111000000000000000222011000000000000000000000000000000000000000200000000110000000111110000000000
0000000000000000000030000000000000001000000000110000000222222200000000000000000000000000000000011111000000000000000000011000000000000000000000000000000000000300000011000110000001111110000000000
0000000000000000000110000000100000001000000000110000000000000000000000000000000000000000000000111111000000000000000000011000000000000000000000000000000000001100000011000110000011111110000000000
0000000000000000000110000300100000001000000000110000000000000000000100000100000100000000000001111111000000000000001000011000000000000000000000000000000000001100000011000110000111111110000000001
1111111111111111111111111111111111111111111111111111111111111111111100000100000111111111111111111111111111111111111111111111111111111111111111100111111111111110111011001111101111111111111111101
1111111111111111111111111111111111111111111111111111111111111111111100000100000111111111111111111111111111111111111111111111111111111111111111100111111111111110111011001111101111111111111111101
