00000000000000000000000000000000000000000000000000000000000000000000000000000000000000000000000000000000000000000000000000000000000000000000000000000000000000000000000000000000000000000000000000000000000000000000000000000000000000000000000000000000000000000
00000000000000000000000000000000000000000000000000000000000000000000000000000000000000000000000000000000000000000000000000000000000000000000000000000000000000000000000000000000000000000000000000000000000000000000000000000000000000000000000000000000000000000
00000000000000000000000000000000000000000000000000000000000000000000000000000000000000000000000000000000000000000000000000000000000000000000000000000000000000000000000000000000000000000030000000000000000000000000000000000000000000000000000000000000000000000
00000000000000000000000000000000000000000000000000000000000000000000000000000000000000000000000000000000000000000000000000000000000000000000000000000000000000000000000000000000000000000110000000000000000000000000000000000000000000000000000000000000000000000
00000000000000000000000000000000000000000000000000000000000000000000000000000000000000000000000000000000000000000000000000000000000000000000000000000000000000000000000000000000000000000110000000000000000000000000000000000000000000000000000000000000000000000
00000000000000000000000000000000000000000000000000000000000000000000000000000000000000000000000000000000000000000000000000000000000000000000000000000000000000000000000020000000000010000110000000000000000000000000000000000000000000000000000000000031100000000
00000000000000000000000000000000000000000000000000000000000000000000000000000000000000000000000000000000000000000000000010000000000000000000000000022220000000000000000000000000000000000000000000000000000000000000000000000000000000000000000000000311100000000
00000000000000000000000000000000000000000000000000000000000000000000000000000000000000000000222222000000000000000000000000000000000000000000000000000000000000000000000000000000000000000000000000000000000000000000000000000000000000030000000000003111100000000
00000000000300000000000000000000000022200000000000000000000222200000000000000000000000000000000000000000000000000000000000000000000000002220000000000000000000000000000020000000000001000000000000000000022000000000000000000000000000001110000001001111100000000
00000000000000030000000000000000000000000000000000030000000000000000300000000000011000000000000000000000000000000000000000000000000000000000000000000000000000000000030010000000000000000000000000000000000000000000000000000000000000000000000000011111100000000
00000000000000110000000000000000000000000000000000110000000000000000000030000000011100000000000000000000000003000000000000000000000000000000000000000000000000000000110000000000000000000000000000000000000001000000030000000000000000000000000000111111100000000
00000000000000110000000000000000000000000000010000110000000000000000000000000000011110000000300000000000000000000000000010000000000000000000000000000000000000000000110001000011000000000000000001000000000001000000110000000000000000000000000001111111100000000
00000000000000110003000000003000330300000000011000110000003300000000000000001000011111000001100000110003300000000000100010000000300330300000330000000000030330000000113001000011000300000000000001000033000001000000110000030000033000000000000011111111100000000
11111111111111111111111111111111111111110000011100111111111111111111111111111000011111100001100000011111111111111111100010011111111111111111111111111111111111111111111111000011111111100000000001111111111111111111110011111111111111100000000111111111111111111
