0000000000000000000000000000000000000000000000000000000000000000000000000000000000000000000000000000000000000000000000000000000000000000000000000000000000000000000000000000000000000000000000000000000000000000000000000000000000
0000000000000000000000000000000000000000000000000000000000000000000000000000000000000000000000000000000000000000000000000000000000000000000000000000000000000000000000000000000000000000000000000000000000000000000000000000000000
0000000000000000000000000000000000000000000000000000000000000000000000000000000000000000000002000000000000000000000000000000000000000000000000000000000000000000000000000000000000000000000100000000000000000000000000000000000000
0000000000000000000000000000000000000000000000000000000000000000000000000000000000000000000000000000000000000000000000000000000000000000000000000000000000000000000000000000000000000000000000000000000000000000000000000000000000
0000000000000000000000000000000000000000000000000000000000000000000000000000000000000000000000000000000000000000000000000000000000000000000000000000000000000000000000000000000000000000000000000000000000000000000000000000000000
0000000000000000000000000000000002020200000000000000001110000000000000000000000000000000000010000000000000000000000000000000000111111110000000000000000000000000000000000000000000000000011110000000000000000000000000011100000000
0000000000000000000000000000000000000000000000000000000000000000000000000000000000000000000000000000000000000000000000000000000000000000000000000000000000000000000000000000000000000000011100000000000000003000000000131100000000
0000000000000000000000000000000000000003000300000000000000111111110000000000000000000000000000000000000000000000000000000000000000000000000000000000000000000000000000000000000000000000000000000000000000000000000003111100000000
0000000000000000000000000000000000000000000000000000000001111111100000000000000000000000000000000000000000000000000000000000000000000000000000000000000000000000000000003000300000000000000000000000000000000000000031111100000000
0000000000000000000000000000030003003000111111100000000011110000000000000000000000000000111111100000000000000000000000000000000000111110000002222000000000000000000000000000000000000000000000000000000000000000000111111100000000
0000000000000001111111111111111113111111100000000000000111110000000000000000000000000000000000000000000000000000000000000000000011000000000000000000000000000011100011100001110000111000000000000000030000000000001111111100000000
0000000000000011100000000000000000000000000000000000001111110000000000000000110000000000000000000000000001111000000000000000000011000000000000030000000000000011000011000001100000110000000000000000000000000000011111111100000000
0000000000000111000000000000000000000000000000000000011111100001100000110000110000011000000000000000000000000000000000000110000011000000000000000000000000010000000000000000000000000000110000000000000000000000111111111100000001
1111111111111111000000000000000000000000000000000000011111100001100000110000110000011000000000000111000000000001110000000111111111111111111111111111111111110000000000000000000000000000111111111111111111111111111111111111111111
1111111111111111000000000000000000000000000000000000011111100001100000110000110000011000000000000000000000000000000000000111111111111111111111111111111111110000000000000000000000000000111111111111111111111111111111111111111111
