000000000000000000000000000000000000000000000000000000000000000000000000000000000000000000000000000000000000000000000000000000000000000000000000000000000000000000000
000000000000000000000000000000000000000000000000000000000000000000000000000000000000000000000000000000000000000000000000000000000000000000000000000000000000000000000
000000000000000000000000000000000000000000000000000000000000000000000000000000000000000000000000000000000000000000000000000000000000000000000000000000000000000000000
000000000000000000000000000000000000000000000000000000000000000000000000000000000000000000000000000000000000000000000000000000000000000000000000000000000000000000000
000000000000000000000000000000000002222000000000000000000000000000000002222200000000000000000000000000000000000000000000000000000000000000000000000000000000000000000
000000000000000000000000001110000011111130000000000000000000000000000011111110000000000000000001110000001111110002000000000000000000111000000000000000000111000000000
000000000000000000001110000000000000000000000000000000000030000000000000000000000001110000000000000000000000000000000000000000000000000000000000011110000000000000000
000000000000000000000000000000000000000000000000000000000000000000000000000000000000000000000000000000000000000000000000000000111000000000000000000000000000000000000
000000000000000020000000000000000000000000000000000000000000000000000000000000000002020000000000000000000000000000000000202200000000000000000000000000000000000000000
000000000000000111000000001110000000000000000000000000000000000011100000000000000002020111000000000011000000011131000001113110000000000000000000000000000000000000000
000000000000000000000000000000000000000000000000000000000000110000000000000000000000000000000000000000000000000000000000000000000000000000011100000000000000000000000
000000000000000000000000000000000000000000000000000000000000000000000000000000000000000000000000000000000000000000000000000000000000000000000000000000000000000000000
000000000000000000000000000000000000000001111311310000111000000000000000000000000000000000000000000000000000000000000000000000000000000000000000000000000000000000001
111111111110000000000000000000000000000000000000000000000000000000000000000000000000000000011311110000000000000000000000000000000000000000000000000000000000001111111
111111111110000000000000000000000000000000000000000000000000000000000000000000000000000000000000000000000000000000000000000000000000000000000000000000000000001111111
