000000000000000000000000000000000000000000000000000000000000000000000000000000000000000000000000000000000000000000000000000000000000000000000000000000000000000000000000000000000000
000000000000000000000000000000000000000000000000000000000000000000000000000000000000000000000000000000000000000000000000000000000000000000000000000000000000000000000000000000000000
000000000000000000000000000000000000000000000000000000000000000000000000000000000000000000000000000000000000000000000000000000000000000000000000000000000000000000000000000000000000
000000000000000000000000000000000000000000000000000000000000000000000000000000000000000000000000000000000000000000000000000000000000000000000000000000000000000000000000000000000000
000000000000000000000000000000000000000000000000000000000000000000000000000000000000000000000000000000000000000000000000000000000000000000000000000000000000000000000000000000000000
000000000000000003000000000000000000000000000000003000000000002220000000000000000000000000003000000000000000000000000000000000000000000000000000000000000000000000000000000000000000
000000000000001111111111100000000000022222220000000001111111111110000111111111111100000000000000300000000000000000000000200000000000000000000000000000000000000000000000011000000000
000000000000000000000000000000000000000000000000000000000000000000000000000000000100000030000000000000000000000000000000300000000000000000000000000000000000000000000000111000000000
000000000000000000000000000000000000000000000000000000000000000000000000000000000100000000000000000000000000000000000000000300000000000000000000000000000000000000000001111000000000
000000000000000000030000000000000000000000000000000000000000300000000000000000000100300000000000000000000000000000000000001100000000300330000000000000000000000000000011111000000000
000000000000001111112111100000222200010000000000000000000001100000010000000000002101100000000000000000000222000000000000001100000001100110000000003000000000000000000111111000000000
000000000000000000000000000000000000000000000000000000000001100000000000000003000101100000000000000000000000000000100000001100011001100110000000000000000000000000001111111000000000
000000000000000000000000000000000000000000000000000000000001100000000000000011000101100000000000000001000000000000100000001100011001100110000000000000000000000000011111111000000000
000000000000000000000000000000000000003300000000000000000001100000000000000011000101103000000000000001030300000000100000001100011001100110000000000000000000000000111111111000000001
111111111111111111111111100001111111111110000000011111111111111111000000000011111111111111111100011111111111111111111111111100011001111111111111111000011100001111111111111111110001
111111111111111111111111100001111111111110000000011111111111111111000000000011111111111111111100011111111111111111111111111100011001111111111111111000011100001111111111111111110001
