0000000000000000000000000000000000000000000000000000000000000000000000000000000000000000000000000000000000000000000000000000000000000000000000000000000000000000000000000000
0000000000000000000000000000000000000000000000000000000000000000000000000000000000000000000000000000000000000000000000000000000000000000000000000000000000000000000000000000
0110000111111111111111111111111111111111111111111111111111111111111111111111111111111111111111112111111111111111111111111100000111111111000000000000001111111111111111111111
0110000001100001100000000000000000000000000000000000000000000000011111111111111111111111111000000111111111111111100000001100000000000000000000100000000000000000000000001100
0110000001100001100000003000000000000000000000000000000000000000011111111111111111111111111000000111111111111111100000001100000000000000000000000000000000000000000000001100
0110000001100001100022222200000000000000000000000000000000000000011111111111111111111111111000000111111111111111100000001100000000000000000000000000000000000000000000001100
0110000001100001100000000000000000011111110000000000000000000000000000000000000000000000000000000000000000000000000000001100000001111111101000000001000000000000000000001100
0110000000000001100000000000000000011111110011111000000000000000000000000000000000000000000000000000000000000000000000001100000001111111000000000000000000000000000000001100
0110000000000001100000000000000000011111110011111000200000222222200000000000000000000000003001100000000000000000000000001100000001111110000000000000000000000000000000000000
0111000000000001100011111111111110011111110011111211211111222222211111111111120000111111111001100000000000000111100000001100000021111100000000000000000000000000011000000000
0110000000000001100011111111111110000000000000000000111111111111100000000000000000000000000001100000000001110111100000001100000000000000000000000000000000000000011000010101
0110000000000000000011111111111110000000001100000000111111111111100000000000000110000000000001100000003311110111100000000000000000000000000000100000002222222200011000010101
0110000000000000000011111111111110000000001100000000000000000000000000000000000110000000000001100000030111110111100000000000000000000000000000000000002222222200011000010101
0111111110011111130011111111111111111111111111111111110110111111111111111111111111111111111111111011131111110111111311111110000111111111000000000000001111111100011000010101
0111111110011111110011111111111111111111111111111111110110111111111111111111111111111111111111111011111111110111111111111110000111111111001000000001001111111100011000010101
