0000000000000000000000000000000000000000000000000000000000000000000000000000000000000000000000000000000000000000000000000000000000000000000000000000000000000000000000000000000000000000000000000000000000000000000000000000000000000000000000000000
0000000000000000000000000000000000000000000000000000000000000000000000000000000000000000000000000000000000000000000000000000000000000000000000000000000000000000000000000000000000000000000000000000000000000000000000000000000000000000000000000000
0000000000000000000000000000000000000000000000000000000000000000000000000000000000000000000000000000000000000000000000000000000000000000000000000000000000000000000000000000000000000000000000000000000000000000000000001111000000000000000000000000
0000000000000000000000000000000000000000000000000000000000000000000000000000000000000000000000000000000000000000000000000000000000000000000000000000000000000000000000000000000000000000000000000000000000000000000000000110000000000000000000000000
0000000000000000000000000000000000000000000000000000000000000000000000000000000000000000000000000000000000000000000000000000000000000000000000000000000000000000000000000000000000000000000000000000000000000000000000000110000000003000000000000000
0000000000000000000000000000000000000000000000000000000000000000000000000030000000000000000000110000000000000000000000002222222222222222200000000000100000000000000000000000000000000000000000000000000000000000000000000110000000011000000000000000
0000000000001003100000000000000000000000000000000000000000000000000000000110000000000000000000110000000000000000000000000000000000000011000000000001100001100000011000000000000000000000000000000000000000000000000000000000000000111000000000000000
0000000000001000100000000000000000000000000000000000000000000000000000000110000000000000000000110000000000000000000000000000000000000011000000000011111000000000000000000000000000000000000000000000000000000000000000000030000001111000000000000000
0000001000101000100000000103300001000000000000022200000000000000003000000110000000000000000000110000000000000000000000000000000000000011000000000111100000000000000000000000000000000000000000000000000000000000000000000000000031111000000000000000
0000001111101112100000000111111111000000000000022200000000000000000000001110000000000000000000111111110000000000000000000011111111111011000000001111100000000000000000000000110000000000000000000000000000000000000000000000000111111000000000000100
0000000000000000000000000000000000000000000000000000000000000022000000000110000000000001000000000000000000000000000000000000000000000000000000011111100000000000000000000001110000000000000000000000000000000300000000000000301111111000000000000000
0000000000000000000000000000000000000000000000000000000000000022000000000110000000000001100000030000000000000000000000000300030000000003000000111111103000000000000000000011110000000000000000000000000000001100000000000001111111111000000000011011
0000000000000000000000000000000000000000000000000000000000000000000000000110000001000001111000000300000000000000000000000000000000000003000001111111111000000000000000000111110000000000000000003000000000001100000000000001111111111000000001011011
1111111111111111111111001111111111113313111111111111331311111111111111111111111111000001111111111111111111111111111111111111111111111111011111111111111000000000000000000111111111111111111111111000000000001111111111100001111111111111111111111110
1111111111111111111111001111111111111111111111111111111111111111111111111111111111000001111111111111111111111111111111111111111111111111011111111111111000000000000000000111111111111111111111111000011000001111111111100001111111111111111111111110
