0000000000000000000000000000000000000000000000000000000000000000000000000000000000000000000000000000000000000000000000000000000000000000000000000000000000000000000000000000000000000000000000000000000000000000000000000000000
0000000000000000000000000000000000000000000000000000000000000000000000000000000000000000000000000000000000000000000000000000000000000000000000000000000000000000000000000000000000000000000000000000000000000000000000000000000
1000001111111111111111111111111211111111111110000000000000112222111111111111111111111111111111111000011111111111111111111111111111111000001111111111111111000000000000011100111111111111111110000000000000000000000000000000001
1000000000000000000000000000000000000000111110000000000011000000000000000000000000000000000000000000011110000000000000000000000000000000001111000000000000000000000000000000111111111111111110000000000000000000111111111111001
1000000000000000000000000000000000000000111110000000011100000000000000000000000000000000000000000000011110000000000000000000000000000000001111000000000000000000000000000000111111111111111110000000000000000001100000000000001
1000000000000000000000000000000000000000111110000000000000000000000000000000000000000000000000000000011110000300000000000000000000000000001111000000000000000000000000000000111111111111111110000000000000000011100000000000001
1000000000000000000000000000000000000000111110000000000000000000000000000000000000000000000000000000000000001100000000000000000000000000000000000000000000000000000000000000111111111111111110000000000000000111100000000000001
1000000000000000000000000000000000000000111110000000100000000000000000000000000000000000000000000000000000001100000000000030000000000000000000000000000000000111000000000000111111111111111110000000000000001111100000000000001
1000000000000000000000000001111100000300111110000030000000111110000000000000000000000000001110000000000300001100000000000110000000000000000200000000000000000000000000000000011111111111111110000000000000011111100000000000001
1000000000000000000000000011111100001100000110000110000001111110000000000000000000111000000000000000001100021110030000000110000000000000001211000000000111000000000000000000011111111111111110000000030000111111100000000000001
1000000000000003000000000111111100001100000110000110000011111110000000000011100000000000000000000000001100000000110000000110011000003000001110000000000000000000111010011111111111111111111110003000110001111111100000110000001
1000000000000000000000001111111100001100000110000110000111111110001110000000000000000000000000000000001100000000110001100110011000011000001100000000000000000000111010011111111111111111111110011000110011111111100000110000001
1000000000000000100000111111111100001100000330000110001111111110000000000000000000000000000000000000001100000000110001100110011000011000000030330001000000000000111010011111111111111111111110011000110111111111100000110000001
1111111111111111100000111111111100111111111111111111111111111111000000000000000000000000000000000111111111100001110001100110011001111111111101111111000000000111111010011111111111111111111110011000111111111111111111111111111
