000000000000000000000000000000000000000000000000000000000000000000000000000000000000000000000000000000000000000000000000000000000000000000000000000000000000000000000000000000000000000
000000000000000000000000000000000000000000000000000000000000000000000000000000000000000000000000000000000000000000000000000000000000000000000000000000000000000000000000000000000000000
000000000000000000000000000000000000000000000000000002222222200300000000000000000030000000000000000000000000000000000000000000000000000000000000000000000000000000000000000000000000000
000000000000111111000000000000000000000000000000000111111111111110001111011111111111110000000000000000000000000000000000111111000000000000000003000000000000000000000000000001100000000
000000000000100000000000000000000000000000000000000000000000000003000000000000000000000000000000000000000000000000000030000000000000000000000011000000000000000000000000000011100000000
000000000000100000000000000000000000000000000000000000000000000000000000000000000000000000000000000000000000000000000000000000000000000000000011000000000000000000000000000111100000000
000000000003100301000000000000000003002000000000000000000000000000000000000000000030000001000000000000000000000000000003000000000000000000300011000000000000000000000000001111100000000
000000000000111211000222220000000011000000000000000002111111111100120000000000000022222221000000000000000000000000000011000110000000000001100222200000000000000000000000011111100000000
000000000000000000000000000000000011000000000000000000000000000001100000000000000000000000000000000000000000000000000011000110000000000001100000000000000000000300000000111111100000000
000000000000000000000000000000000011000000000000000000000000000011100000000000000000000000000000000000000000000000000011000110000000000001100000000000000000001100000001111111100000000
000000000000000000000000000030000011000003030000000000000003000111100000000000100033000000000000033000000000003303000011000110000000000001100000030000000030001100003011111111100000000
111111111111111111111111111111111111111111111111000111111111111111111110000000111111111111111111001111111111111111111111000110011111111111110000010001111111111111111111111111111111111
