00000000000000000000000000000000000000000000000000000000000000000000000000000000000000000000000000000000000000000000000000000000000000000000000000000000000000000000000000000000000000
00000000000000000000000000000000000000000000000000000000000000000000000000000000000000000000000000000000000000000000000000000000000000000000000000000000000000000000000000000000000000
00000000000000000000000000000000000000000000000000030000000000000000000000000000000000000000000200000000000000000000000000000000000000000000000000000000000000000000000000000000000000
00000000000000000000300000000000000000000000000000110000000000000000000000000222000000000000000000000000000000000000000000000000000000000000000000000000000000000000000000000000000000
00000000000000000000000000000000000000000000000000110000000000000000000000000222000000000000000000000000000000000000000000000000000000000000000000000000000000000000000000000000000000
00000000000000111113111110000000000000000000000011111000000000000111000000001111000000000000001111002000000000000000000000000000000000000000000000000000110000100011000001110000000000
00000000000000000000000000000000000000000000000000000000000000000000000000000000000000000000000000002000000000000000000000000000000000000000000000000000000000000000000000000000000000
00000000000000000000000000000000000000000000000000000011100000000000000000000000000011100000000000000011100000000000000000000000000000000000000000000000000000002222222000000000000000
00000000000000000000000000000000000000000000000000000000000000000000000000000000000000000000000000000000000000000000000000000000000000000000000000000002222000002222222000000000003000
00000000000111113133111111100000000000000013111000000000000000000000000000000000000000000000000000000000000000001113110000011110000000000000001110000001111000000000003000000000000000
00000000000000000000000000000000000000000000000000000000000000000000003000003000000000000000000000000000000000000000000003000000000001110000030000000000000000000000011000000000000000
00000000111000000000000000000000000000000000000000000000000000000000011000011000000000000000000000111000000000000000000000000000000000000000110000000000000000003000011000000000000000
00000000000000000000000000000000000000000000000000000000000111000000011000011000000000000000000000000000000000000000000000000000000000000000110000000000000000011000011000000000000001
11111111111000000000000000111111111133131100000000000000000000000000111100111111110000000113100000000000000111110000000000000000000000000000110000000000000000011000011000000000000011
00000000000000000000000000000000000000000000000000000000000000000000000000000000000000000000000000000000000000000000000000000000000000000000110000000000000000011000011000000000000011
