000000000000000000000000000000000000000000000000000000000000000000000000000000000000000000000000000000000000000000000000000000000000000000000000000000000000000000000000000000000000000000000000000000000000000000000
000000000000000000000000000000000000000000000000000000000000000000000000000000000000000000000000000000000000000000000000000000000000000000000000000000000000000000000000000000000000000000000000000000000000000000000
000000000000000000000000000000000000000000000000000000000000000000000000000000000000000000000000000000000000000000000000000000000000000000000000000000000000000000000000000000000000000000000000000000000000000000000
000000000000000000000000000000002220000000000000000000000000000000000000000000000002000000000000000000000000000000000000000000000000000000000000000000000000000000000000000000000000000000000003001110000111000000300
000000000000000000000000000000002220000000000000000000000000000000000000000000000000000000000000000000000000000000000000000000000000000000000000000000000000000000000000000000000000000000000000000000000000000000000
000000000000000000000000000000000000000000000000000000000000000000000000000000000003000000000000000000000000000000000000000000000000000000000000000000000000000000000000000000000000000000000000000000000000000000000
000000000000000000022220000000000000000000000000000000000000000000000000000000000000000000000000000000022220000222200000000000000000000000000000000000000000000000000000000000000022220000000001000000000000000000000
000000000000000000022220000000000000000000000000000000000000000000000000000000000000000000000000000000022220000222200000000000010000000111000000000000000030000000000000000000000022220000000000000000000000000000000
000000011001000000000000000003000001111113110000000000003000000000001110000000110000000000000000000000030000000000000000000000000000000000000000000000001110000000000011100011000000000011100000000000000000000000000
000000111001000000000000000000000001000000010000000000000000000000000000000000000000000000000000000000000000000000000000000000000000000000000000000000000000000000000000000000000000000000000000000000000000000000000
000001111001000011111111111111100001000000010001111111111111111000000000001100000000011100000111311111111111311111111100000000000000000000000011100011000000000111000000000000001111111000000000000000000000000000001
111111111001000010000000000000100001000000010001000000000000001000000000000000000000000000000100000001000000000000000100000111111300000000000000000000000000000000000000000000001000000000000000000000000000000000001
111111111001000010000000000000100001000000010001000000000000001000000000000000000000000000000100000001000000000000000100000000000000000000000000000000000000000000000000000000001000000000000000000000000000000000001
