000000000000000000000000000000000000000000000000000000000000000000000000000000000000000000000000000000000000000000000000000000000000000000000000000000000000000000000000000000000000000000000000000000000000000000000000000000000000000000000000000000000000000000000000000000000000000000000000000000000000000000000000000000000000000000000000000000000000000000000000000
000000000000000000000000000000000000000000000000000000000000000000000000000000000000000000000000000000000000000000000000000000000000000000000000000000000000000000000000000000000000000000000000000000000000000000000000000000000000000000000000000000000000000000000000000000000000000000000000000000000000000000000000000000000000000000000000000000000000000000000000000
000000000000000000000000000000000000000000000000000000000000000000000000000000000000000000000000000000000000000000000000000000000000000000000000000000000000000000000000000000000000000000000000000000000000000000000000000000000000000000000000000000000000000000000000000000000000000000000000000000000000000000000000000000001111111111111111111111111111110000000000000
001000000000000000000000000000000000000000000000000000000000000000000000000000000000000000000000000000000000000000000000000000000000000000000000000000000000000000000000000000000000000000000000000000000000000000000000000000000000000000000000000000000000000000000000000000000000000000000000000000000000000000000000000000001111111111111111111111111111110000000000000
000000000000000000000000000000000000000000000000000000000000000000000000000000000000000000000000000000000000000000000000000000000000000000000000000000000000000000000000000000000000000000000000000000000000000000000000000000000000000000000000000000000000000000000000000000000000000000000000000000000000030000000000000000001111111111111111111111111111110000000000000
110110000000000000000000001111000000000011111111111111110000000000000000000000000000000000000000000000000000000000000000000000000011000000001110000000011110000000001100000000000000000000001111000000000000000000000000000000000000000000000000000000000000000000000000000000000000000000110000000003011111000000000000000000101111111111111111111111111111110000000000000
110110000000000000000000000000000000000000000000000000000000000000000000000000000000000000000000000000000000000000000000000000000111000000001110000000011110000000001100000000000000000000000000000000000000000000000000000000000000000000000000000000000000000000000000000000000000000001110000003000000000000000000000000000001111111111111111111111111111110000000000000
000000000000000000000000000000000000000000000000000000000000000000000000000000000000000000000000000000000000000000000000000000001111000000001110000000011110000000001100000000000000000000000000000000000000000000000000000000000000000000000000000000000000000000000000000000000000000011110000000000000000000000000000000000001111111111111111111111111111110000000000000
101011100000000000000000000000000000000000000000000000000000000000000000000000000000000000000000000000000000000000000000000000011111000000001110000000011110000000001100000000000000000000000000000000000000000000000000000000000000000000000000000000000000000000000000000000000000000111110000000000000000000000000000000001001111111111111111111111111111110000000000000
101011100000222200000000000000000000000000000000000000000000000000000000000000000000000000000000000000000000000000000000000000111111100000001110000000011110000000001100000000000000000000000000000000000000000000000000000000000000000000222000000000000000000000000000000000000000001111110000000000001110000000000000000000001111111111111111111111111111110000000000000
111111100000000000000000000000000000000000000000000000000000000000000000001000000000000000000030000000000000000000000000000001111111000000001110000000011110000000001100000000000000000000000000000000000000000000000000000000000000000000000000000000000000000000000000000000000000001111110000000000000000000000000000000300001111111111111111111111111111110000000000000
010101100000000000000000000000000000000000000000000000000000000000000000031000000000000000000000000000000000000000000000000011111111000000001110000000011110000000001100000000000000010000000000000000000000000003000000000000000000000000000000000000000000000000000000000000000000001111110000000000000000000000000000000000301111111111111111111111111111110000000000000
010101100000000000000000000000000000000000000000000000000000003000000000001330000000000000000000000000003033000000000000000111111111000000001110000000011110000000001100000000000000010000000000000000000000000000000000000000003300000000000000000003303000000000000000000330001000001111110000000000000000000000000000000000001111111111111111111111111111110000000000010
111111111111111111111111111111110000011111111100110011001111111111111111111111111111111111111111111111111111111111111111111111111111110000001110000000011110000000001111111110001111111111111111111110011001111111100111111111111111111111111001111111111111111111111111100111111000001111110000000000111111111111111111111111111111111111111111111111111111110011111111111
