0000000000000000000000000000000000000000000000000000000000000000000000000000000000000000000000000000000000000000000000000000000000000000000000000000000000000000000000000000
0000000000000000000000000000000000000000000000000000000000000000000000000000000000000000000000000000000000000000000000000000000000000000000000000000000000000000000000000000
0000000000000000000000000000000000000000000000000000000000000000000000000000000000000000000000000000000000000000000000000000000000000000000000000000000000000000000000000000
0000000000000000000000000000000000000000000000000000000000000000000000000000000000000000000000000000000000000000000000000000000000000000000000000000000000000000000000000000
0000000000000000000000000000000000000000000000000000000000000000000000000000000000000000000000000000000000000000000000000000000000000000000000000000000000000000000000000000
0000000000000000000000000000000000000000000000000000000000000000000000000002200000000000000000000000000000000022220000000000000000111000000000000000000000000000111000000000
0000000000000000000000000000000000000000000000000000000000003000000000000000000000000000000000000000000000000000000000000000000000000000000000000000000000000000000000000000
0000000000000000000000000000000000000000000003000000000000000000000000000000000000000000000000000000000000000000000030000000000000000000000000000000000000000000000000000000
0000000000000000000000000000000000000000000000000000000000000000000000000022000000000000000000000000000000000000000000000000000000000000000030000000000000000000000000000000
0000000000000000000033030000000000000000000000000000000000000000000000000000000000000000000000000000111111100000000000000000111100000000000000000222222222001110000000000000
0000000111111111111111111110000000001111111111110000000000000011111111000000000000000000000000000000000000000110011001100000000000000001100000000000000000000000000000000000
0000001111100000000000000010000000001000000000010000000000000000000000000000000000030000000000000000000000000000000000000000000000000000000000000000030000000000000000000000
0000011111100000000000000010011110001000000000010111111111100000000000000111111111111111100000000000000000000000000000000000000000000000000011111111111111000000000000000000
1111111111100000000000000010000000001000000000010100000000100000000000000100000000000000100111111110000000000000000000000000000000000000000010000000000001000000000000011111
