11001110011110011111001111100111
10000000000000000000000000000001
10000020030000000002000200000001
14111111111111111111111111111141
14100000000000000000000000000141
14100020000000200000000000200141
14111111111111111111111111114141
14100000000000000000000000004141
14100200000000302000000000004141
14141111111111111111111111414141
14141000000000000000000001414141
14141412000000030000020001414141
14141411111111111111111111414141
14141400000000000000000000414141
14141400000200000000000020414141
14141111111111111111111111114141
14140000000000000000000000004141
14140000020000000000000200004141
14111111111111111111111111111141
14000000000000000000000000000041
14000003000020005000020030000041
11111111111111111111111111111111
