00000000000000000000000000000000
00000000000000000000000000000000
00000000000000000000000000000000
00000000000000000000000000000000
00000000000000000000000000000000
00000000000000000000000000000000
30000000212000000000000000012000
11111411111111111141411111111114
00001400000000000041400000012004
20001400000000000041400001111114
11141111141111111111111141000004
20040000040000003000000041411111
14111111111111111111411141400002
04111111111111111111411111111111
24112000100000000021400003012000
11411111111111411111111411111111
11400000000003411201100400110021
20400000041111111111141114111111
11411111141021111111241114000011
11411111141111111111141111114111
11000000100000010500040010004002
11111111111111111111111111111111
