00000000000000011100000000000000
00000000000000011100000000000000
00000000000000011100000000000000
00000000000000011100000000000000
00000002002000011100002000020000
11111111111111411141111111111111
00200000020000411140200000000020
41111111111111111111111111111114
40000000000000011100000000000004
40000002000200011100000000200024
11111111111111411141111111111111
00203002003000411140020300032000
41111111111111111111111111111114
40000000000000011100000000000004
40000000002200011100000200002004
11111111111111411141111111111111
00000002000200411140002000000002
41111111111111111111111111111114
40000000000000000000000000000004
40000000000000000000000000000004
40000000000000005000000000000004
11111111111111111111111111111111
