10000000000000000000000000000001
10000000000000000000000000000001
10000000000000000000000000000001
10000000000000000000000000000001
10000000000000000000000000000001
10000000000000000000000000000001
10000002000000000000000000000001
10111101111111111111111111111121
10000000000000244440000044444441
10000000000004110011111000001141
10000000000204000000021001021241
10000000001114000050011001111141
10000002000004111114001030000001
10000001110004100014001444411111
10000000000304120014001000444401
10000000041111111114111000400201
11111111041201020010001000401111
12000001141111111110001000401001
11111111144442212212001111141111
10000000140011111111141000040021
10020000140000200000044003041401
11111111111111111111114111111111
