00000000000000000000000000000000
00000000000000000000000000000000
04444444444444444444444444444444
41030001000000000000000001000001
40111110000000000000000000111114
40101110000000000000000000121114
40111110000000000000000000111114
40111010030000030000300000111014
40111111111111111111111111111414
40111111111112011102111111111414
40111111111111111111111111111414
40111111111111111111111111111414
40111111111111000001111111111414
40111111111111000001111111111414
40111111111111000001111111111414
40111111111111000001111111111414
40111111111111000001111111111414
40111111111111000024111111111414
40000000000000111114444444444404
40000000000001111114000000000004
40000000000001111110000000000004
40000000500011111100000030000004
