11111111111111111111111111100000
10201000020500000003000000100000
14141114111111111111111110100000
14140114244444444444444000100000
14140114120000000200000140100000
14140114112000000000000140100000
14114014411200000000000140100000
14014014441120000000000140100000
14011401144112000000002140400000
14001400114411200000021144400000
14001140011441120000211044100000
14000144001144112202110044100000
14400114000114411111100044100000
14442004400011441111000144100000
14444004400001144110001444100000
10444434140000114100244424100000
14420044110000004000144441100000
11141111211140004000444344100000
14444444400144044044420044100000
14044020040040444144111114100000
10041411114000004440000004000000
11111444424111114411111111100000
