44444444444200000000011111111100
40000000004144444440001111111100
40000000041114002420030111111100
40000000041114001114000011111114
40000000041114301114000001110014
40000000041114001114000000110014
43000000041114001114000000012014
40000000044444001114000000001114
40000000000400001114000000000114
14444400011411000004000000000014
11200400011411000004000000000004
11120400011411004444000000000004
11112430011411004004444444444444
11111400011411004000000000000000
00000400011411004000000000000000
00000400011411004444444444112111
00000400011411004000000041111111
00000400011411004000000411111111
00000400011411004000000411111111
00000400011411004000000411111111
00000400050400004000000411111111
11111111111111111111111111111111
