01111111111111111000111110000000
04444444444444001000102410000000
00000000000004441000111410000111
24000000000004001444020410000004
14000000000004001400111410000004
14000000000054001400130410444444
44111111111114001400114110400004
40001111111114001400004000400000
40001000000014001400004000400000
41111000000014001400004000400200
40011000000014001400004000411111
44011000000014001400004000400000
14011100000014001400004000400000
14001100000014001400004000400000
14001122222214001140004000400000
14000111111114000111404000400000
14111444441114000001114400411114
14000030000001114000011411000004
14111111140000001140000410000004
14111111141111141111114411100004
14111111141111140200204412000004
14111111111111111111114411111114
