00000000000000000000000000000000
00000000000000000000000000000000
00000000000000000000000000000000
00000000000000000000000000000000
00000000000000000000000000000000
00000000000000000000000000000000
00000000030000000002044400000000
44444444411111111111110040000000
40000000400000000000020040000000
40000001111111111111111111000000
40000001201000100000100001000000
40302201001002100220102201000000
41111111001111111111111111111110
41001011111000001000000000000000
41021020010004201000500000000000
41111111111114111111111111111111
40000000000004000000000000000000
40000000000004000000000000004000
40000000000004000000000000040000
40000000000004000000000000040020
40000000020004000000000000040111
11111111111114000002000030040020
