01000000000000000000000000000010
01000000000000000000000000000010
01003022222222200022222222203010
01111111111111110111111111111110
00000000000000000000000000000000
00000000002200000000000220000000
00000000141110000000114110000000
00000000042200000000204200000000
00000001141141000001111141000000
00000000000040000000000040000000
00000000020240000000002240000000
00000014111141100011411111100000
00000004000000000000400000000000
00000004200020000000420002000000
00000114111111410111411111410000
00000000000000400000000000400000
00000002000002404000200020400000
00001411111111110111111111111000
00000400000000000000000000000000
00000400000000000000000000000000
00000402000002000000200050200003
11111111111111111111111111111111
