00000000000000000000000000000000
44444444444440000000000000000000
00002002000140000002000000000000
11111111111111111111140004140000
11111111111110000001140204140000
00000000000110000001111111140000
00000000000110000000000001143200
44444444440110000200000001111114
00000000040111111111400000011114
00000000040110000000400000011114
00000000040110000000430000010014
00200002040110001111111114010014
11100001040110001000000014010214
11100001040110001000000014011114
11103001040110001000000014011214
11111111040110001000002014011014
00000000040000001111111114000014
00000000040000001000200014000014
11111111111111111041114011111114
00000000000000000040004000000004
00000000000005000040204000000004
11111111111111111111111111111111
