00000000000000000000000000000000
00000000000000000000000000000000
00000000000000000000000000000000
00000000000000000000000000000000
00000000000000000000000000000000
00000000000011100000000000000000
00002030200011100000230002000000
41111111111111141111111111111111
44444444444011140044444444444440
00000000000411140000000000000004
00000000000411140000000000000241
04444444444411142000000000324111
40200444450011111100000002411111
11111000014011111100000241111111
00401000014011111100224111111111
11241000014011111100411111111111
21141000014444440241111111111111
11241000014011104111111111111111
21141022014011104000000000000000
11241111114011104111111111111114
21140030004211124120000000000004
11111111111111111111111111111111
