11111111111111100011100000000111
11111111111111100011100000000111
00020000011111100011100000002102
41111111110000100301100000004104
41111100000000041111111111114104
41001100000000041111111111114104
41001100000000041111111111114104
41111100444444441111111111114104
41021144400011141000000111114114
41114440000011141444444100114114
41144400000000041000000020114114
41442000000111141000000111014114
44401444444444440000444440114014
00011300200000141111100520004114
11111110111111141111111111104004
11111000000000141000000320111111
11111000000000141111000111100201
11111444444444440000000000011111
11111000000000140000000000011111
11111000000000040000000000011111
11000000200000040004111111111111
11111111111400040004111111111111
