00000000000000044444440000000000
00000000004444400000000000000000
00000444440000000000000000320200
04444400000000000000000320111114
40000000000000000002001111100014
40002000202000502111111000000014
40011110111100111100000000020014
40000000000000100000000023111414
40202000200000100020201111101414
40111011111000100111111000001414
40000000000000100100000000201414
40000200020200100100000201141414
40011101111100100100201111141414
40000000000000100100111100141414
40202000020000100100100020141414
40111011111000100100102014141414
40000000000000100100101114141414
40000000000000100100101014141414
40000000000000100100101014141414
40000000000000100100101214141414
40000000000003100100101114141414
11111111111111100000000004040404
