00000000000000000000000000000000
00000000000000000000000000000000
00000000000000000000000000000000
00000000000000000000000000000000
00000003000000000000000300000000
00000000000000000000000000000000
00000000000000000000000000000000
00000000000000000000000000000000
00000000000000000000000000000000
00000000000211141112000000000000
00000000000101040101000000000000
00020200001040404040100002020000
00011414111111404111111414110000
00210414000000404000000414010000
00104414444444404444444414401000
00143201444444414444444102341000
00011140140000404000041041110000
00000114111111141111111411000000
00001104000002040200000401100000
00001041144444414444441140100000
00020411144414444414441114520000
11111111111111111111111111111111
