00000000000000000000000000000000
00022020203030300000500000000000
41111111111111111111111111111114
40000000000000000000000000000004
40000000000000000000000000000004
40001020200000000020000000021004
41111111111111111111111111111114
40000000000000000000000000000004
40000000000000000000000000000004
40000102000000002000000020010004
41111111111111111111111111111114
40000000000000000000000000000004
40000000000000000000000000000004
40000010002000000020000002100204
41111111111111111111111111111114
40000000000000000000000000000004
40000000000000000000000000000004
40000000000000000000000000000004
40000000000000000000000000000004
40000000000000004140000000000004
42022200000300004140300000041111
11111111111111111111111111111111
