10011111111111111111111111111111
10000000000000000000000000000001
10044444444444444444444444444441
10011111111111111114111111444141
10010000000000000004000000004141
10010000200200020004000200004141
10024111111111111111111111114141
10014140000000000000000000024141
10014101111111111111111111111141
10024101000000000000000000001041
10014101002222222222220000021241
10004101111111111111111111411141
10024100000000000000000000401041
10014100000300000000000000421241
10014111111111111111111111410141
10024000000000000000000000404141
10014444444444444444444444404141
10011111141111111111114111114241
10003000040000110000004030204141
11111111111111114111111111111141
00000000000000004000000000000041
00000000050000004000000000000041
