00000000000000000000000000000000
00000000000000000000000000000000
00000000000200000000000200000020
41114000041114000004111111410014
40001111110004111114000000400004
42300000000004000004000000400204
41111100000004000014100001111104
40111110000004000110000000000004
40111111000000001100000000000004
40111111100000011000000000004104
40111111110000110000000000414004
40111111111111110000000000400004
40111000011111110000200000400011
40111000011101110001111000400000
40111000011000110000000000400000
40111000011000110000000000400000
40111020011020110000030000400032
40111411111111111411111111400011
40000400000000000400000000400011
40000400000000000000000000400011
40000400000005000000000000400011
11111111111111111111111111111111
