00000000000000000000000000000000
00200000000000000000000000000000
11114000000000000000000000000000
00004000000000000000003000000000
20004000000000000411111111402000
11111111411111111400000001111111
00000000400000000400020000000020
00000020400000000411111111111111
14111111400002000400000000000000
04002000411111111400000020000000
14111111400000000111141111111114
00000000400000000000040000000004
00000000403000000200040000000004
00200000411141111111111111111111
11114111100040000000000000000000
00004000000040000200000002003000
00004000000411111111141111111111
00004444444400000000040000000000
00004000000000000000040000000000
00004000000000000000040000000000
00004000000005000000040000000200
11111111111111111111111110111111
