00000000000000000000300000000000
00004444000444444404444444404444
00004000212000000044401104440000
00040002101200000040011110040222
25040021000120000440100001044022
11110110010011000401100001104002
03000100111001004401100001104403
41111001000101114000102201000414
40000040111000020004411110000004
40000004010000240041141100000004
40000000400002440040040444444444
40000000000024400042240000000004
40000000444444000411114044444444
11111140000040000400004000000004
00000040000000000420024000000004
00000040000000004111111404444444
11111141114000004000000400000004
00000000004000004200002400000004
00000000004000041111111140044444
00000000004000040000000040000004
00000000004030042003000240000004
11111111111111111111111140000004
