04444420000000000000000000000000
00000014000000000000000000000000
00000014000000000000000200200510
00000014000000000000041111111110
00000014000000000000411111111110
00000014000000000004111111110010
02003014000000000041111111112010
11111001400000000412111111111110
00000100142000004104111111110010
20000120011400041004111111110010
11114010001423412004111111110010
00004010000114111114111111110010
20000401000014100004111111110010
11400401200014102024111111110010
00400040100014111114111111110010
20400040120014000044111111110010
14014014010014202044111111110010
04004004010014111104111111110010
01401401400000000004111111111110
00400400400000000004111111110000
00400400400000030004000000000000
11111111111111111111111111111111
