00000000000000300000000000000000
00000000000000000000000000000000
00000000000000000000000000000000
00002000000001141100000000020000
00411140000004444400000004111400
04102014041144444441140041020140
04111111411444444444114111111140
00000000004444424444400000000000
00000300004444444444400000000000
01111111114444444444411111111110
01121100001444444444100000112110
00111000000144444441000000011100
00010000000014444410000000001000
00000000000001444100000000000000
00000000000000141000000000000000
00000000000000141000000000000000
00000000000000141000000000000000
00000000000000141000000000000000
00000000000000141000000000000000
00000000000000040000000000000000
00003000000000040000050000000000
01111111111111141111111111111110
