00020000002000000200000032000000
41111111411101111141110111111114
40000000400000000040000000000004
04000004000040000004000000000040
04000004000404000004000000000040
40000000404000400044444444444444
40000000440000040040000000000004
04000004000000004004000000000040
04000004000000000404000000000040
44444444440000000440000000000004
00030000404000004040000000000004
11110004000400040004000030200204
11110004000040400004004111111111
10110000400004000040004111111111
00200000400040400040004111111111
11110004000400040004004002200111
11110004004000004004004111111111
00000200440000000440024111111111
11111110400000000040111111111111
11110004000000000004000111111111
00000004000000250004000111111111
11111111111111111111111111111111
