00000000000000000000000000000000
00000000000000000000000000000000
00000000000000000000000000000000
02400000042000000420000004200000
04200000024000000240000002400000
02400000042000000420000004200000
04200000024000000240000002400000
02400000042000000420000004200000
04200000024000000240000002400000
02400000042000000420000004200000
04200000024000000240000002400000
02400000042000000420000004200000
04200000024000000240000002400000
02400000042000000420000004200000
04200000024000000240000002400000
02400000042000000420000004200000
04200000024000000240000002400000
02400000042000000420000004200000
04200000024000000240000002400000
02400000042000000420000004200000
54200000024000003240000302400300
11111111111111111111111111111111
