00000000000000000000000000000000
50000000000000000000000000000000
00000000000000000000000000000000
22222222022222222000224444444440
11111111411111111204110000000000
11111111411111111124110000022222
00011000411111111114110000011111
00011000411100011114110022211111
00011000411100011114110011111000
00011000411100011114112211111000
00011000411100011114111111000000
00011000411100011114111111220000
00011000411100011114110011110000
00011000411100011114110011010000
00011000411100011114110011012200
00011000411100011114110000011100
00011000411122211114110000111100
22211222411111111114110000111122
11111111411111111104110000001111
11111111411111111004110000001111
30000000400003000004000000000003
11111111111111111111111111111111
