11111111111110000001111111111110
11111111111110000001111111111010
14444444444444444444444444011010
10041111111114000001444444444440
50042122220004000001200022400020
11141111111114000001111411111410
10044444010024000001200444444400
12000124002214000001100401110420
11111111111114000001200430022414
10002122010014000001111111411114
10001111010014444441000000400220
10222002212014003041100000401114
14111111111411111111111141111114
14444444444411104444444444104444
14000000000400040000000040140004
14000000000400040000000040140004
14020002220400240202000040142021
11411411411111141111111111111411
00400400400000040000000000000400
00400400400000040000000000000400
00400400400000040000000000000400
02422430400000040000000000022422
