00000000000000000000000000000000
00000000000000000000000044444444
00000000000000003000000040000004
11111411000014111000000340000204
00000400000004000000111141111111
00000400000004000000000040000000
00000400000004000000000040000000
00300400002004000000000040010000
11111411111004000000000040020000
00000400000004000000000040010000
00000400000004000000000040000000
00000400000004000000000040000000
00200400002004000000000040000000
11411111111114111140000040000000
00400000000000000040200040111104
00400000000000000044444440111104
00400020000001000000000040120104
11111111400002000000000040111114
00000000400001000121000040000004
00000000400000000000000040000004
00000000405000000000002040030004
11111111111111111111111111111111
