00000000004000000000000000000000
00000000004000000000000000000000
00000000004000000000000000000000
03200000004000000000000000002300
41110320004000000000000023001114
40001111004111104111140011110004
40000000000000004200040000000004
40000000000000024400040000000004
40000000000000044000040000000004
40000000000000004200040000000004
40000000000000024400000000000004
40000000000000044000000000000004
40000000000000004200000000000004
40000000000000024400000000000004
40000000000000044000000000000004
40000000000000044200000000000004
40000000000000004400000000000004
40000000000000024000000000000004
40000000000000044200000000000004
40000000000000004400000000000004
40000000000500024200000000000004
40000000411111111111111400000004
