00000000000000000000000000000000
00000000000000000000000000000000
00000000000000000000000000000000
00000000000000000000000000000000
00000000000000411400000000000000
00000000000000411400000000000000
00000000000032411423000000000000
00000000000041111114000000000000
00000000000241111114200000000000
00000000004111111111140000000000
00000000324111111111142300000000
00000000411111111111111400000000
00000000400000000000000400000000
00000000400022222222000420000000
00000041111111111111111114000000
00000241111111111111111114200000
00041111111111111111111111114000
00041111111111111111111111114000
00040000000000000000000000004000
00040000000000000000000000004000
00040000000000050000000000004000
11111111111111111111111111111111
