00000000000004444440000000000000
00000000000004000004400000000000
00000000000004000000044000000000
00000000000004000000000440000000
44444444444014000000000004420200
00002112000414111111111111111111
00021001200414000020002000444444
00210000120411111111111114000004
02100000012411111111111114002004
01000000001400000000000011111114
00000000000000000000000010000004
00000000000000000000000010000004
00020052000000000000000010000004
41111111111403020002000010202034
40000000000411111111111111111114
40032000200411111120111100000004
41111111111411111111011100000004
40000000000411111111101100000004
40002002000411111111110100000004
41111111111411111111111000000004
40000200200411111111111002020004
11111111111111111111111111111111
