10000000000000000000000000000001
11000000030000000000000000000011
41100000411100041113004111000004
40010001444410144441014444100014
43011011000410102041010204110124
41111111111411111141111114111114
41111001111400111140011114001114
41110000111400011140001114000114
41110200111402041140001114005114
41111144111111141144111114411114
40011144001111140044111004411004
40001114000111140041110004110004
40000114200111140041110004100004
40000111144111144111114411100004
41111111144111144111114411111114
41100111141001141110011411100114
41000011140000141100001411000014
41000001140000041000000410000014
41100111111441111114411111100114
40000000000440000004400000000004
40002000000440020004400000002004
41111111111111111111111111111114
