00000000000000000000000000000000
00000000000000000000000000000000
22244444422202224444444444444222
11100000011141110000000000000111
11100000011141110000000000000111
11100000011141110000000000000111
11100000011141110000000000000111
11100000011141110000022200000111
11100000011141110000011100000111
11100000011141110000011100000111
11100000011141110000011100000111
11100000011141110000011100000111
11100000011141110000011100000111
11100000011141110000011100000111
11100000011141110000011100000111
11124444211141112444211124442111
11110220111141111202111112021111
11111111111141111111111111111111
01111111111040111111110111111110
00111111110040011111100011111100
00300000000540000000000030000000
11111111111111111111111111111111
