00000000000000000000000000000000
00000000000000000000000000000000
00034444400000444000000000030000
01111004000011044000000000011400
01111004000011044003000044411400
01221004000000441111111100444400
01111004444000001111111100404000
00000004004000001111111100404111
00444404004000001111111100400121
00000000004000001100001100400111
00000111104000001102201100400000
00000111104000001111111100400000
00004122104000001111111100400000
01114111104444400000444404400000
01210000004000444454440040000000
01110000004000000000000040111110
00000000004000000000000040111110
00000000004000000111000040100010
00001100004000000121000040122210
00001100004000000111000040111110
00000000004000000000000040000000
00000000004000000000000040000000
