20011111111111101111111111111111
41444000040002101000000000000001
41210111101111101411141111111141
41210100100020101411141111111141
41210122111111101400141111111141
41210111111111101114140000032141
41210002000300000014141111111141
41210111411112000214141111111141
41210000400011111114140000000041
41214111211400000014111111111141
41214100001400000014000000000141
41214100001400200014000002000141
41214102001111111411111111111141
41214041140000001400000000000141
41214041143200001400000020000141
41211111111111141111111111114141
41210001000100040010000000004141
41210001000100040010000000004141
41212001020102042010000020004141
41214141414141111111111111111141
41114140414141000004000000000041
40204142414241500204000020000041
