00000020000000200000000000000000
41111111111111111111140000004000
40000000000000000200044444444000
11111111111111111111110000004000
11111111114000000000000000004002
11111111144000000000000000004111
11000011444444444444000000004000
11200211440000000004000000004000
11111114400000000004000000004000
11111114400000003004020003004002
11111144000004111111111111114111
11111144000004000000000000004000
00000040000004000000000000004000
00000040000004000000000000004000
00000040000004444444444444444000
00000340002004000000000000004002
41111111111114020000000000204111
40000000000004011111111111104000
40000000000004000000000000004000
40000000000004000000000000004000
40000002000004000050000200004000
11111111111111111111111111111111
