10000000000000000000000300000000
11111111111111111111111111111100
23000000010000002000010200000000
11141011414111111110014100111411
11141011414100000010014100111411
11141411414100000010014100000404
10141411014100200010014100000404
10141411014101111010014100111114
12141411414141001010014100140004
10141411414141501010014100140004
10041411414141101010014100141111
10041411414140021010014100140004
00041411414111111010014100140004
04110411414000000010014044111114
41100411414000000010014100140004
40040411414002000010014100140004
40001411411111111110014100141111
40001411400000000000014100140004
41101411400000000000014100140004
44101411111111111111114100111114
00000400000003000000004100000004
11111111111111111111111100300004
