00000000000000000000000000000000
00000300000000000000000000000000
00000000000000050000000000300000
00024200000000000000000000000000
00244420000000000000000000010000
02444442000000000000000000111000
24444444200000000000000001111100
44444444400000000000000011111110
44444444444000232000444444444000
44444444401111111111100000040000
44444444401020000020100000040000
44444444401044444440100000040000
00021200001040000040100000040000
02111110001040000040100000040000
01111111001040000040100000040000
00111110001040000040100000040000
41111111401040000040100000040000
40000000401040000040100000040000
40000000401240003042100000040000
40000000401111111111100000040000
40000000400400000004000000040000
41111111441111111111144111111114
