00000000000000000000000000000000
00000000000000000000000000000000
00000000000000000300200000000000
00000000000020011111141002000000
00000000111111110000041111111100
00000000100000010000040000000100
00000000103200010000040000000100
00001111111102010001411111122100
00001000000111111111400000111111
00001000000100000200400320000401
00001000000100004111111111111041
00001000000100004100000000002041
00001000000100004102000414041111
00001000000100141111000411111000
00001000000100140001000410000000
00001000202100140001000410000000
00001001111100140001000410000000
00001111000102140001000410000000
00000001020111140001002410000000
00000001111100140001111110000000
00000000000000040000000500000000
11111111111111111111111111111111
