00000000000000000000000000000000
00000000000000000000000000000000
44444444444444444444444444444000
40000000000000000000000000004000
40000000000000000000000000004000
40000000000000000000000000004000
11111111141111111141122000011000
11111111141111111141111000011000
00011100041100001141111000011000
00011100041100001141111200011000
00011100041100001141101100011000
00011100041122221141101122011000
00011100041111111141101111011000
00011100041111111141100011011000
00011100041100001141100011011000
00011100041100001141100011211000
00011100041105001141100011111000
22211122241100001141100001111000
11111111141100001141100001111000
11111111141100001141100000011000
30000000040000000040000000003000
11111111101114411101111111111111
