44444444444400000000000030000000
40000000000001000000000000000000
40000000000001002000041111401014
40111111111101111141041000401014
40111111111101002041041410401014
40111111111101411111041410401014
40111111111101402001041410401014
40111122111101111141041410401014
40111111111101002041041410401014
40111111111101411111041410401014
40111111111101402001041410401014
40111111111101111141041410401014
40111111111101000041041410401014
40111111111101002041041410401214
40000000000031411111041410401114
41111111111111402001041410400004
41111111111111111141111411111114
41111111111111002041111411111114
41122111111111411111020002010114
41111111111112411111111111111114
41111111111111100000000003000004
40000000050000041111111111111111
