00000000000000000000000000000000
00000030000000000000000000000000
01111111111111111111111111111114
00000000000000000000000000400004
20000000000000000000000000400004
11110000000000010000000024442004
11111111441441111402000011011004
00000001441440101111110000000004
00000001440440101111110000000004
00000001440440101111100000003004
00000001442440101011101111141114
00000001111111101211100000040004
00000000000000000000000000040004
00000000000000000000000000040004
00000000005000000011411111141114
11411111111114111110400022000004
00400000000004000000400011000114
00400000000004000000400011111114
00400000000004000001111011111004
00411112110004000000000011000004
00411111110034000000200000000004
11111111111111111111111111111111
