40000000000000000000000000440444
40004400000000000000000000401000
40000400000000000000003000401022
40000411111111102204111111141111
40200400000000111111100000044411
41110400000000000000000000004441
40000400000000000000000000000441
40000044444444444444444444444444
40000040000000000000000000000004
40000040000000000000000000000004
40000040000000000000000000000004
40000040020000000003002000000024
40000011111141111111111111111111
44444000000040000000000004444400
40000000000040000000000004000000
00032000000040000000000004000000
11111111140040002000000004400000
00000000111111411141111111012111
00000000000000400040000000011111
00000000000000400040000000011111
02000500000000400040000030011111
11111111111111400041111111111111
