00000000000000000000000000000000
00000000500000000000000030000000
00000011411444444444441141100000
00000010401200000000021040100000
00001112401110000000111042111000
00001000400010000000100040101000
00001200400212000002120040101000
10001110401111100011111140121001
10000000400000100010000040100001
10000000400000102012000040100021
10000000411111114111100040111411
10000000400000004000000040000401
10000000400000004000001140000401
10020300400003004000000040000401
14111111400011114111100040001441
04100200400012004002100040031140
04111100400110004000110040011140
04000100400100004000010040012040
04020100400100004000010040010040
04000011111000004000001111100040
04000011111000004000001111100040
11111111111111111111111111111111
