00000000000000000000000003000000
00000000000000000000050000000000
00001111111144111111444444400000
00000000000004000100400000000000
00000000000004404100400000000000
00000000000000444100400000000000
00000000000000044100400000000000
00000112000000004100400000000000
00001111200000004100400000000000
00011111120000004100400000000000
11111111112000004100400000000000
11111111111000004100400000000000
00011111110000004100400000000000
00211111100000004100400000000000
00001111000000004100400000000000
00000110000000004100400000000000
00000000000000004100400000000000
00000000000000004100400000000000
00000000003000004100400000000000
04111111111111111111111111111140
01111111111111111111000000004110
11111111111111111111002222224111
