00000000000000000000000000000000
00000444444444444444444444441111
40023000000000000004000000000001
41111110000000000004000000000001
40000010000000000004000000000001
40000010000000000004000000000001
40000010000000000004000000000001
40040010000000444444023401102001
40240010200000000004111411111111
41142011111111020004000400000000
00041111111111111114001400000002
40041100201111111114021444444111
41141111111111111114111402040111
40000014444444444444121411140111
40000010000000000004111400040111
42340010000000000004111444440111
11140010000000000004121402040111
00040010000020000004111411140111
00040010002011000004111400040111
00040010201100000004111400040111
00040511110000000204111400340111
11111111111111111111111111111111
