00000000000000000000000000000000
04444444444444000000000000000000
40000000400000102010000040000000
40000004440000111110000444000000
40002000400020000000200040002000
40004400400440000000440040044000
40004044444040000000404444404000
40004044444040004000404444404000
40004002320040044400400232004000
40000411111400004000041111140000
40000044444044004004404444400000
40000000000040444440400000000000
40000000000040444440400000000000
40000000000040444440400000000000
40000000000040023200400000000000
40000020000004111114000000200000
41111111400000444440000041111111
40000000400000000000000040000000
40000000400000000000000040000000
40000000400000000000000040000000
40000000400000002000500040000000
11111111111111111111111111111111
