00000000000000000000000000000000
00000000000000000000000000000000
01111111111111000011111111111110
01444444444441000014444444444410
00120004000210000001200040002100
00010004000100000000100040001000
00001204021000000000012040210000
00000124210000011111111242100000
00000014100000010000000141000000
05000014100000010000200141003000
11114114111111111111111141111114
00004004000000000000000040000004
41111114003000000000000040000004
44444114111111111111111141111111
40021004144444444444441141000000
40010004012000000000210041000000
40100004001200000002100040100000
42100214200120004111000040010000
41002104120111141111000040001020
40001004014400040001000040000111
40210004211400040001030040200111
11111111111400040201111111111111
