00011111111111000000000000000000
00110000000001100000000000000000
01100000000000110000000000001110
11000200300020001400000000001110
11114111111111111140003000021110
11144411111111111111411111411111
11144411444444444114441144444444
11140411005000000114441100400004
11140411020000000114041102002004
11140411000000000114041100000004
11140411000000000114241110000014
11142411111411111111111111111114
11111111111411111100000000000014
10000000114441111000000000000004
10000000144444000000200000200204
14444444144044444444444444444444
11001111140004000000000000000004
11120111140004000000000000000304
11110011140004000011111111111114
11111001140004000112111111020114
11111100040004000011111111111114
11111111142024111111111111111111
