00000000000000000000000000000000
00200000000200000000000000200020
41111100004111100004111111111114
40000000004000000004000000000004
40200002004000000204000200000204
41114111114000111111111111111111
40004000304000444444444444444444
11114111111111400000020000203004
00004000000000400111111111111114
00004111111110400100000000000004
00004000000010400100000020002004
10004000020010400100000111111104
11221111111110400100200100220104
11111111111110400111111141114104
00000000000000400100000040004104
02000200000000400100000040034104
11111111110000400111111111111104
00000000011111111111110000000004
02002000000000000000000000000004
11111114000000000000000000000004
11111214000000000000000002002054
11111114000000000000004111111111
