00000000000000000000000000000000
00000000000000030000300000000202
00000004111111111111111000411111
00000004111111111111110000411111
00000004011211211211100004111111
41111111001011011011000044111111
41111111100000000000000411110000
41111111110000000000004111110000
41111111111111111111111111110000
41111111111100000000000011110000
41111111111102002002020011110202
41111111111111111111111111111111
40000000000000000002111111111100
40000003000000000044111111100000
40041111141111140004111110000241
40040040040040040004111000024111
40042242242242240011100002411111
40041111141111140010000241111111
40000000000000000000004111111111
40000000000000000000411111111111
40000000000000500004111111111111
41111111111111111111111111111111
