40000000000000000000000000000000
40000000000000000000000000000000
40000000000000000000000000000000
40000000000000000000000000000000
40000000000000000000000000000000
40000000000000000000000000000000
40044000000444444444444444444444
40000000000400000000000400000304
40000000002400002000000400041111
11101111111444444444000400040000
02000000000402000004000400011114
11141110300444444444000400000004
00040201111100002004000400041111
05040111110144444444000400040200
41044444444444444444000400011114
41111111111111000030000400000004
42001111000001204111111114000004
41111111111111114111111111101111
41111111111111004111111111101112
41111111111111414111111111101111
41021111111111414000000000000000
40111111120000411111111111111111
