00000024441114411144420000000000
00002444111444444111444200000000
00244411144400004441114442000024
04441114440000000044411144400444
44111444000000000000444111444411
44444400000000000000004444444444
41111100000000000000001111144111
41111100000000000000001111144111
44444420000000000000024444444444
44111444200000000002444111444411
04441114442300003244411144400444
00044411144420024441114440000004
00000444111444444111444000000000
00000004441114411144400000000000
00000000244414414442000000000000
00000024441114411144420000000000
00002444111444444111444200000000
00244411144400004441114442000024
04441114440000000044411144400444
44111444000000000000444111444411
44444420000000000000024444444444
41111140000000050000041111144111
