00000000000000000000000000000000
00000000000000000000000000000000
40000000000000000000000000000004
40000000000000000000000000000004
40000000000000000000000000000004
40000000000000000000000000000004
40000040200000000000040020400004
40000041111400000000041111400004
43200041111400000000041111400024
11114041111444444444440211404111
00004040021400000000041111404000
00204041111400000000041111404200
41111041111444444444442111401114
40000040211400000000041200400004
40200041111400000000041111400204
11114041120400000000041111404111
00004042011400000000040021404000
00204041111444444444441111404020
41111040211400000000041112401114
40000041111400000000040211400004
40050041122400000300041111400304
11111111111111111111111111111111
