00000000000000000000000000000000
00000000000000000000000000000000
00000000000000000000000000000000
00000000000000000004444444444000
00000000000000000004000000000000
00000000000000000004000000000000
00004444440000000004000000000000
01110000004440003004111100000000
01200000044401111114111100000000
01110000044001111114122100000000
00000111100001111114111100000000
00000111101141122114000011110000
00000122101101111114000011110000
00000111100000000004000012210000
00000000000000000004000011110000
00000000011110000004000000001111
11111000012210000004111100001111
11111000011110000004111101141122
10201000000000000004122101101111
11111000000000000004111100000000
00000000000000300004050000000000
11111111111111111111111111111111
