10000000000000000000000000000001
10444444444444444444444444444401
10000000000111141111000000000001
10000000211100040001112000000001
10000001110000040000011100000001
10002111220222242222322111200001
11111111111111141111111111111111
11110000000000040000000000001111
11000000000000040000000000000011
10000000000000040000000000000001
10000000000000040000000000000001
10000000000000040000000000000001
10000000000000040000000000000001
10000000022220043022220000000001
10000041111111141111111140000001
10000040000000040000000040000001
10000240022222240200222240300001
10041111111111141111111111140001
10040000000000040000000000040001
10040000000000040000000000040001
10040000000000040050000000040001
11111111111111111111111111111111
