00020000400000403004000000430000
41110411211111211140400004040000
40020411111111111140420402040000
41110411021112011144004040440000
40020411111111111140200020040000
41110411102120111140440040040000
40020411111111111140402042440000
41110411120102111140004004040000
40020411111111011140040400040000
41110411201110211144004040440000
40020411111111111140020004040000
41110412011111021140004402040000
40020411111111111140400404040000
41110410211111201140204040440000
40020411111111111140000000040000
41110411021112011140000000040000
40020411111111111140000000040000
41110411102020111140000000040000
40020411111111111140000000040000
41110411120102111140000000040000
40300411111111111140000050000000
41111400201110200041111111111111
