00000000000000000000000000000000
00000000000003200000000000000000
00000000000011111111114000000000
00000000000000000000004000302000
00000000302000000000004141111114
00000201111114000000004040000004
11111111000004444444444042000004
00000000000004000000004011111111
00000000000004000000004000000000
00020000000004000000004444444444
11411111111114000000004000000000
00400000000004000000004000000000
20400000030004000200004000000002
11111111111101111111114000001111
00000000000000000000004000000000
00000000200002000000004000000000
11111141111111140020004000200000
00000040000000011111111111111114
00000040000000000000000000000004
00000040000000000000000000000004
00000040200005000000000200000004
11111111111111111111111111111111
