00000000000000000000000000000000
44444444444444444000000000000000
40000000000000004000000011111140
40000000000000004000000000000040
40000000000000004003000000000040
40000000000000004111111104104010
40000341400000004444444014014000
11111111414105000000004001100110
44444444404111111110114011400110
40000000404102100020004010414410
40000000404100211110114024120220
41200000004103111110004014100010
41100000004101111120114004141110
40110000000102111110204001041100
40011000000101111110414011140110
40001100000140212010404001041020
40000110000141111110414010110110
40000011000140000000004000000000
40000001100140000000004000000000
40000000100040000004004000000000
40000000000140000000004000000000
11111111111111111111111111111111
