00000000000000000000000000000000
00000000000000000000000000000000
00411111111111111111111111111140
00404110000002002032000000114040
00411141114041111111404111411140
00404040001110000000111000404040
00404040001110020203111400404040
00114111114041111111404411114111
00404040404040411140404040404040
00404040404040400040404040404040
00414111104040402040404011111140
00404040404043411143404040404040
20404040404041411141404040404042
11114111424141411141414241114111
11404040414141411141414140404041
11404041414141411141414141404041
11404041414141411141414141404041
11414141414141411141414141411141
11404141414141411141414141414041
11414040404040400040404040404141
11414040404040400540404040404141
11111111111111412141111111111111
