44444444444444444444444444444444
05000000000000000000000000300004
44444044000044444040004022222204
44444044000044444044004000000204
44044044000044044044004000000204
44044044000044044044404000000204
44044044000044044040404000000204
44044044000044044040404000002204
44044044000044044040404000002004
44044044000044044040404000022004
44444044000044444040404000020004
44444044000044444040404000220004
44044044000044044040404000200004
44044044000044044040404000200004
44044044000044044040404000200004
44044044000044044040404000200004
44044044000044044040404000200004
44044044000044044040444000000004
44044044000044044040044000000004
44044044444044044040044000200004
44044044444044044040004000000004
11111111111111111111111111111114
