00000000000000444000000000000000
00000000000004444000000000000000
00000000000000044000000000000000
00000000000000444400000000000000
03000000000004444440000000000030
44444444444444444444444444444444
44444444444444444444444444444444
04444444444444444444444444444440
00044444444444444444444444444000
00000444444444444444444444400000
00000004444444444444444440000000
00000000044444444444444000000000
00000000000004444440000000000000
00000000000004444440000000000000
20202020202004444440020202020202
00000000000004444440000000000000
00000000000004435440000000000000
11111111111114411441111111111111
11111111111114411441111111111111
00000000000000400400000000000000
02020202020000400400002020202020
11111111111111111111111111111111
