00000000000000000000000000000000
00000000000000000000000000000000
00000500000000000000000000000000
00000400000011002400000000000000
00000000000000124040000000000000
00000000042140014002000000000000
00000000001104204003041000000000
04240000000100404111110444444000
20402000021022044022100021000000
00402020010000044000012210400000
00400000400000444440001100020000
40404402004444044000000040000000
01410200000000041400000000000000
00400200004444441411100010000000
44444000000000041420010014440000
20402000000000041400201102000000
20402000000044441402000000000000
00400000000000041400002000000000
00400000000000041400000000000000
00400030000000041400000000000000
11111111111111111111111411111111
11111111111111111111111100020001
