04444444444440000000004444444440
40000000000000000000000000000004
40000000000111111111111100000004
40000003001111111111111110300004
40000111111111111111111111111104
40000000000000000000000000000004
40000140000000011111000000004104
11111140444444000000044444404111
00000040000000000000000000004000
00000040000000000000000000004000
00000040000000000000000000004000
00000040000000000000000000004000
00000040000000000000000000004000
00000040000000000000000000004000
00000042000200020002000200024000
00000040000000000000000000004000
00000040000000011111000000004000
00000040000011111111111005004000
00000040011111111111111111004000
00000040001111111111111110004000
00000040000111111111111100004000
00000040000001111111110000004000
