00000000000000000000000000000000
00000000000000000000000000000000
00000000000000000000000000000000
00000000000000000000000000000000
00000000000000000000000000000000
00000000000000000000000000000000
00000000000000414444444444441111
00000000000004111400000422040404
00000000000441111144000044240404
00000000000411111114000000442424
00000000000411111114000000044444
00000000000411111114000000040404
00000000000421111124000000040404
00000000000411111114000000042424
24444444444411111114000000044444
42000000000421111124000000040404
14200000000411111114000000040404
11420000000411111114000000042424
11142000000421111124000000044444
11114200000411111114000000040404
11111420004110111011400000542424
11111140034110111011430004111111
