00001000001000000010000000000001
00001000001000000010000000000001
00001111111000000011111011111001
11200000000011114300020000000001
11111111111400004111111111000241
00000005000401114100000200000141
14111111111402114101111114000141
14444444411401114101000004000141
10010010011401114101000004000141
10010010211400004101000004000141
10010010011400004101011114000141
10010010014400004401211114000141
10010210014411111411011114000141
10011110014100000001000004000041
10010010014101111101000004111441
14110011414101101101111111111441
14000011414101121101000000000401
14000111414100001001000000000401
14000111444100001001000000000401
14000110441100001001200000000411
14000100041111111111111111111411
14111000040000000300000000000401
