00044444444004000000000000000000
00400000000440000000400000000000
00444444443444444444044111114000
00400000004100444444041044401400
00400000041014000000410000400140
00400440410001404404100000420014
40144004124110140041000000400001
41014004111111140410000200400001
11111004100100140054444444444441
11111004100100140010000000000001
11111004100100140011111111011111
11111004100120144400000000400034
11111004111111100411111111011114
11111004100100140412111111011114
10201004100100140411111111011214
11111004102100140410000000010004
11111004111111140410000000010004
11111004100100140410000000010004
11111004100100140410000000010004
11111004100120040410000000010004
11101004111111140411111111111114
10200014000000141400000021002004
