00000000000000000000000000000000
00000000000000000000000000000000
00000000000000000000000000000000
00000000000000000000000000000000
00000000000000000000000000000000
00000000000000000000000000000000
00000000000000000000000000000000
00000000000000000000000000000000
00000000000000000000000000000000
44444400000030041400300000444444
40000444444441241421444444400004
41201400000041111111400000410214
41111000000044410144400000011114
44110000000000411140000000001144
04110000000000410140000000001140
04110000000000411140000000001140
04110000000000410140000000001140
04110000000000411140000000001140
04110000000000410140500000301140
04111111111111411141111111111140
24110000002001402041000200001142
11111111111111111111111111111111
