00000000000000000000000000000000
00000000000000000000000000000000
00000000000000000000000000000000
00000000000000000000000000000000
03022000000141000000000000000000
41111111110141000444444440500000
41000000000141000000000011111002
41444440000140000000000000000004
41000000000142000000000000000004
40000000020141000020000000000004
40002111111141001111444444000204
41111100000141200000000000411104
41444444444141111000000000410004
41000000000241000000032000410004
41000002000141000111111111110004
41000011111141000002000000002004
41000000000141444111144400041004
41020000000141000000000002040004
41111100000141000000000111110004
40000000000141000000000000000004
40000030000040000000000000000004
11111111111111111111111111111111
