44444444444444444000000000000000
00000200000000000430000000000000
00002220000000004440000000000000
00002220000000004440000000000000
00022000000000044000000000000000
02202220000004404440044444444000
22022002200044044004400003000000
00044000000000044000000044444000
03044400000000044400000022222000
44440440000044440440000044444000
00000440000000000440000022222000
00000440000000050440000044444000
11111111111114111111111111111111
00000000000004000000000000000000
00000000000004000000000000000000
00000000000004000000000000000000
00000000000004000000000000000000
00000000000004000000000000000000
00000000000004000000000000000000
00000000000004000000000000000000
00000000000004000000000000000000
11111111111111111111111111111111
