10111111111111111111101111111111
14000001111110100000000011111111
14000001002220000030000000000001
14000001011114141111400000000001
14050201000004040211400200000001
14111101022204041111411111111001
14000001011104041111411111111001
14020001000004041111411111111001
14111001000004041111411111111001
14000001000004240011411111111001
14000001002004140112421111112001
14000021011104140011411111111001
14000111001004140000444444444001
14003001000004140011400000021111
14111141000004140010400000110001
14001041000004240010400000001201
14001041000004140010400000001141
14001040000044442010412222222241
14001241111102141111111111111111
14001141000111111144444444444441
14020040020002000000000000022241
11111111111111111111111111111141
