00000000000000000000000000000000
00000000000000000000000000000000
00000200002000000000000000000000
22111111111111111111111400000000
11000000000000000020200400000000
00000000000004111111111400000000
00000000000004000000000402000200
00000000000004000000000411111110
00000020302004000000000000000000
00041111111111444444444000020000
00040000000000400000004111111114
00040000000000400000004000000004
00240000000000400000004000000004
11140000003000403020004000000204
00000000411111411111114000411111
00000000444444444400000002400001
00000200420000000000041111400000
11111111140000000000040000400020
00000000040000000000040000411111
00000000040000000000040000000000
00000000040000000000040000000000
00000000040000002050040000000200
