00000000000000000000000000000000
00000000000000000000000000000000
00000000000000300000000000000000
41111111111111111111111111111114
41111111111111111111111111111114
40000000011144444444111000000004
40000000011140003002111000000004
40000200011140111111111000003004
40011110011140111111111001111114
40011110011140000000111001111114
40011210011140000000111001112114
40000000011140000000111001111114
40000000011140000000111001112114
40005000011111111144111001111114
40011110011111111144111001111114
40011110011111111144111001111114
40011110011100000040111000000004
40011110011100000040111000000004
40011110011100000240111000000004
11111111411141111114111411111111
11111111400041111114000411111111
11111111402041111114200411111111
