11111101111111111111111111011111
00000101444444444000000000000001
00000101010000014100000000000001
01100001012000014100000000003001
00111111011111114111112011411111
10044444444411114011111111410111
10002000000010014010111111410111
11111000000010014010111111410111
00000000000010014010111011412001
00003000000000014010111011411111
41111111114142014012001011411121
40000000004111114111111011411101
40000000000001004000000000400001
40000000000100004000000000400001
41114111111141111111111111411111
41114111111141111110011111411111
41114111111141111110011111411111
40004000000041111111001111400000
40004000000041111111000111400000
41111111111141111111120001111114
40000000000040011111111000000004
40050000000040211111111000300004
