00000000000000000000000000000000
00000000000000000000000000000000
00000000000000000000000000000000
20000000000000000000000000000000
14444444444444440444444444444241
11423000000000000000000000000411
11144444444444444404444444444111
11114000000000000000000000241111
11111444444444044444444444411111
11111142000000000000000034111111
11111114444444440444444441111111
11111111400000000000002411111111
11111111140000000000004111111111
11111111114444404444441111111111
11111111114200000000041111111111
11111111111400000000411111111111
11111111111144444044111111111111
11111111111140000024111111111111
11111111111114444441111111111111
11111111111111400411111111111111
11111111111111450411111111111111
11111111300200411400200011111111
