04000000000000000000000000000040
40111111111111111111111111111104
40100001000000010000000010000104
40100001002002010000000010000104
40102001111111110000000010000104
40111111000000100000000010000104
40100010000000120300200010002104
40100010000000111111111111111104
40102010000000100000001000000104
40111110020030100000001000000104
40100011111111110000001000000104
40100000010000010000001000200104
40100000010000012000301111111104
40100000010000011111111000000104
40100000010000010000100000000104
40102002010000010000100000000104
40111111110000010000100000000104
40100001000000010000100000000104
40102001200032012000120000000104
40111111111111111111111111111104
40000000000005000000030000000004
11111111111111111111111111111111
