00000000000000000000000000000000
00000000000000000000000000000000
00000000000000000000000000000000
00000000000000000000000000000000
00000000000000000000000000000000
00000000000000000000000000000000
00000000000000000000000000000000
00000003000000000020000000000000
00114111100000000011114111111111
00004000012000000100004104444444
04444444441000001444444140000002
12004002000100010000004144444440
01304444414010100020004100000004
00100000104001000000004120000004
50010001004000000000204104444444
11101010004144444444104140000000
00001100004010200001004140003000
24111000000001000010204111111114
14100000000000100100114111111114
04000000000000011000004000000004
04000000000000000000004000000004
11111111111111111111111111111111
