00000000000000000000000000000000
00000000000000000000000000000000
00000000000000000000000000000000
00000000000000000000000003400004
00000000000000000004111111041114
00000000000000000004100001041114
00000000000000041111110001041114
00000000000000041000010001041114
00000000000411111100010001041114
00000000000410000100010001041114
00000004111111000100010001041114
00000004100001000100010001041114
00041111110001000100012221041114
00341000010001000122211111041114
11111100010001222111110000041114
10000100012221111100000411111114
10000122211111000000003410000114
10000111110000000004111111000114
12222100000000041111102221222114
11111100000000041111111111111114
00000004111111111100000005000004
00000004111111111111111111111111
