11111111011111000000044444440030
00000000044440300000000000111114
00000004101111141111114444441004
41111111101444444444410000411141
40000000001020040000010000400040
40000000001111000011410000420040
40000000001444444444410000440040
40000000001000040000410000400040
40001000001000040000410000400040
40051000001000040000410000400042
14111000001421242142410000411141
04000000001111111111110000004000
04000000001000020000010000004000
04000000001001111400010000004000
04000000021000000400010000004000
04000001111000000400010000411111
04000211001000000400012000400000
04000110001002000400011000400000
04021100001041111114010120400000
04011000001041000014000010400000
04000000200040002004000000400000
11111111111111111111111111111111
