00000000000000000000000000000000
00000000000000000000200000003000
11111100000000000001111411111111
00001110000000000011100400000000
00000111000000000111000400000000
00000011100000021110000400000000
20300011110000011110000400002000
11141111111000111114111111111111
00040000111141111004000000000000
00040000000040000004000000000000
00040000000040000004000000000000
00042300000040000004000002000000
41111400000040000011114111000000
40000400000040000000004000000000
40000400000000000000004000000000
40000400000000000000004000000000
40000400000020000003004000000000
40000411111111411111111111114111
40000000000000400000000000004000
40000000000000400000000000004000
40000000000000400050000000004000
11111111111111111111111111111111
