00000000000000000000000000000000
00000000000000000000000000000000
00000000000000000000000000000000
00000000000330000033000000000000
00000000000000000000000000000000
00000000002220111022200000000000
00002222201111111111102222200000
00001111110000050000011111100000
00000000000000000000000000000000
00000000000000000000000000000000
00000000000000000000000000000000
00000000000000000000000000000000
00000000000000000000000000000000
00000000000000000000000000000000
00000000000000000000000000000000
00000000000000000000000000000000
00000000000000000000000000000000
00000000000000000000000000000000
00000000000000000000000000000000
00000000000000000000000000000000
00000000000000000000000000000000
11111111111111111111111111111111
