00000000000000440000000000000000
00000000000000440000000000000000
00000000000000440000000000000000
00000000000000440000000000000000
00000000000000440000000000000000
00000000000000440000000000000000
00340000000000440000000000403000
01141100000111441110000011411000
11242110001111441111000112421100
10040000011200440021100100400000
11242044411000440000000112420000
01141100011200443020000011411000
00242110001111441110000002421100
00040010000111441111044000400100
11242110000200440021100112421100
01141100000000440001100011411000
00040000000000440001100000400000
00000000011200443021100000000000
00000000001111441111000000000000
00000000000111441110000000000000
00000000005000440000000000000000
00000004111111441111114000000000
