11111111111111111111111111111110
11111144444444444444444444111110
11000040444000044004440004000010
11000040444000044000440004000010
11050040444000044000040444003010
11111140444044044044040004111110
11111140444044044044040004111110
11000040444044044044040004000010
11000040444044044000040444000010
11030040004000044000440004003010
11111140004000044004440004111110
44444444444444444444444444444444
44020040204002044020040204002044
44444444444444444444444444444444
44000040404044044044040004000044
44044040404044044044040004044044
44044040404004044004040444044044
44000440404040044040040004000444
44044040404044044044040444044044
44044040004044044044040004044044
44044040004044044044040004044044
44444444444444444444444444444444
