00000000040000000000000000000000
00000000040000000020000300000000
00000000040000001111111111111114
44444020000000000000000000000004
40011111110000000000000000000004
40000000004444440004444444041111
40000000000000000000040000040000
44444444444000000000040000040000
00000030000000002000041000040000
41111111111111111111111000011114
40000000000000000000000000000044
40000000000000000000000000000040
40000000020000002000000300010040
11111111111140111111111111110040
00000000000040000000000000000040
00000000000040000000000000000040
00000002000040000020000000000040
41111111111110111111111100000040
40000000000000000000000044444440
40000000000000000000000000000040
40000000000000000000000000000040
40000000050000000000000300000000
