11111111111111110000000000000000
10000000000000014111111111120000
10444444444444444000000001014440
10000000000000041000020001013004
10000000000000041000000001001104
12023000000050041000000001000004
14111111141111111110000001000004
14000000140000000110000001000004
14000000040000000110000001000004
14000000044444444400000004000004
14200000040000000000000004000004
14000001144444444440000304000004
14000001040000000011111114000004
14000111240000000010000001400004
14000100140000001110000001400041
14011100140002111210000001411111
14110000140000100010220001411011
14120000140011100011111111410101
14000000140110000014444441411011
14000000444100000010002001412101
14000000414000000000000001411011
11111111111111111111111111111111
