44444000002222222222220000044444
40000111111111111111111111100004
40111111111111111111111111111104
40000111111111111111111111100004
43140111111111111111111111104134
11140111111111111111111111104111
00040100000100000000100000104000
00040100000100000000100000104000
00040122222122222222122222104000
00040111111111111111111111104000
00040111111111111111111111104000
00040111111111111111111111104000
00040100000100000000100000104000
00040100000100000000100000104000
00040100000100000000100000104000
00040100000100000000100000104000
00040122222122222222122222104000
00040111111111111111111111104000
00040111111111111111111111104000
00040111111111111111111111104000
00040111111111111111111111104000
00040000000000000000000000054000
