11111111411441141111114010001000
11111111411441141111114014141412
44411444411441141144440014141412
00411400411111141111140014141412
00411400411111141111140014141412
00411400411441141144440014141412
00411400411441141111114014141412
00411400411441141111114014141412
44444444344334434444440014141412
11111111411441141111400014141412
11111111411141141111140014141412
11444444411141141144114014141412
11111114411141141144114014141412
11111114411411141144114014141412
11444444411411141144114014141412
11111111411411141111140014141412
11111111411441141111400014141412
44444444044004404444000014141412
01022222222222222222222224140402
01111111111111111111111111111114
02222222222222222222222222222224
11111111111111141111111111111111
