00000000000000000000000000000000
11111114111143000034111141111110
44000004000041144114000040000044
40111111000000044000000011111104
40111111000000044000200011111104
40111121000144444444100012111104
40111111000141111114100011111104
40111111000141111114100011111104
40111111000141111114100011111104
40111111000144444444100011111104
40000000000000000000000000000004
40000004000044444444000040000004
43000004000000011000000040000304
41111114000000011000000041111114
40000004000000111100000040000004
40000004000002111120000040000004
41111114000011111111000041111114
40000004000011111111000040000004
40000004001111111111110040000004
41111114021111111111112041111114
00000004111111111111111140000000
20000004111111111111111140000502
