23000000000111111111111111111111
11400000000111111111111111111111
41111111140030001111111111111111
41111111111111141111111111111111
41111111110111141111111111111111
41111111110111141111111111111111
41111111110111141111111111111111
41111111110111141111111111111111
41111111110111140000111111111111
41111111110111111143000111111111
41111111110111111111140000000000
41111111110111111111111111111114
41111111102011111111111111111114
41111111111102011111111111111114
41111111110111102011111111111114
41111111110111111100011111111114
41111111110111111111402011111114
41111111110111111111411101111114
41111111110111111111411101111114
42000000020000200201411101111114
11111111111111111100411100000054
11111111111111111111111111111111
