11111111114444444444441111111111
11111111144000000000044111111111
11111111440000000000004411111111
11111114400004000040004441111111
11111144000000133100000044111111
11111440000040111104000004411111
11114400000401111110400000441111
11144444444011111111044444444111
11440000040111122111104000004411
14400000001111111111110000000441
44000000040111122111104000000044
14400000004011111111040000000441
11440000000401111110400000004411
11144000000040111104000000044111
11114400000004000040000000441111
11111440000000000000000004411111
11111144000000000000000044111111
11111114400000000000000441111111
11111111440000000000004411111111
11111111144000000000044111111111
11111111114300050000341111111111
11111111111111111111111111111111
