00000000000000000000000000000000
00000000000000000000000000000000
00000000000000000000000000000000
00000000000041111114000000000000
00000000003041003014030000000000
04444440000041020014000004444440
40000004111111111111111140000004
40000004100001000010000140000004
40000004100001000010000140000004
40000004100001000010000140000004
40000004100001000010000140000004
40000004100001000010000140000004
40000004100201302010020140000004
41111111111111111111111111111114
41000000100001000010000100000014
41000000100001000010000100000014
41000000100001000010000100000014
41000000100001000010000100000014
41000000100001000010000100000014
41000200100201002010020100020014
44414114141141411414114141141444
44114114041145411434114041141144
