44444444444444444444444444440000
00000000000000000000000000040000
00000000000000000000000000040000
00200000200000200000200000040000
11110011110011110011110011040000
00000000000000000000000000040000
20000002000002000002000002040000
11100111100111100111100111040000
00000000000000000000000000040000
00000020000020000020000020040000
11001111001111001111001111040000
00000000000000000000000000040000
00000200000200000200000200040000
10011110011110011110011110040000
00000000000000000000000000040000
00200000200000200000200000040000
11110011110011110011110011040000
30000005000000000300000000040003
11111111111111111111111111110111
11111111111111111111111111110111
11111111111111111111111111000001
11111111111111111111111111030301
