00000000000000000000000000000000
00000000000000000000000000000000
00002000300020000020000300020000
00011111111114000411111111111000
00000000000004000400000000000000
00000000000004000400000000000000
00000004111111111111111400000000
20030024000000000000000420030002
11111114000000202000000411111111
00000004020021111120020400000000
00000004011111111111110400000000
00000004011111000111110400000000
00000004000000000000000400000000
00000204000000020000000402000000
00041111111111111111111111140000
00040000000000050000000000040000
00040200241111111111142002040000
11111111140000000000041111111111
00000000040000000000040000000000
00000000040000000000040000000000
00000000040000000000040000000000
11111111111111111111111111111111
