00000000000000000000000000000000
00000000000000000000000000000000
00000000000000000000000000000000
00000000000000000000000000000000
00000000000000000000000000000000
00000000000000000000000000000000
00000000041100000001140000000000
00000000411000000000114000000000
00000004110000000000011400000000
00000041120000300000021140000000
00244411111111111111111114442000
04140001120000050000021100041400
04414000110200000002011000414400
04441400011110000011110004144400
02444140000010000010000041444200
00244414000010020010000414442000
00024441400011111110004144420000
00002444140000444000041444200000
00000244414000444000414442000000
00000024441400444004144420000000
20300002441140444041144200000302
11111111111111111111111111111111
