11111111111111111111111111111101
11111111111111111111111111111101
11111111111111111111111111110001
11111111111111111111111111110111
11111111111110000000000001110001
11111111111114111111111121111101
11111111111114111111111111111101
00000000000004000000000000000000
00000000000004000000000000000000
00000000002004011020002000000000
00000000011111411411111100000000
00000000000000411400000000000000
00000000000000444400000000000000
00000000400030040000004000000000
00011111014111141411110114111000
00010001014000101400010104011000
00010021014200101400210124001000
00011111014110101411110104001000
00010001014000141000010104001000
00010001014002101000010104011000
00011111014111101111110114111000
50000000000000000000000004000000
