00000000000000000000000000000000
00000000000000000000000000000000
00000000000000000000000000000000
00000000000000000000000000000000
00000000000000000000000000000000
00000000000000000000000000000000
00000000000000000000000000000000
00000000000003000000000000000000
44403004444401111140000300000000
41111110111111142111111111140000
41121110120004141100020002040000
41111110111114040004444444040000
40000000044444040004000000040000
11111140000000040004001000040000
44400041111110111111141111110000
20004110000044441044444444440000
00004100111400001244444444020000
41111001000111401444444444040000
40000010041111401244444444000000
40004100041111401444444444000000
40504140041021401111111111140000
11111111111111100000000000040000
