00000000000000000000000000000000
00000000000000000000000000000000
00000000000000000000000000000000
04444444444440050004444444444440
40000000000001111110000000000004
40000004444001111110044440000004
40000004440111111111104440000004
40000004440111111111104440000004
40000004401111111111110440000004
40000004011111222211111040000004
40000004011111111111111040000004
40000004111111111111111140000004
40000000112222111122221100000004
40000000111111111111111100000004
40000000111111222211111100000004
40000000111111111111111100000004
40000004011111111111111040000004
40000004011111111111111040000004
40000004001222211222210040000004
40000004400111111111100440000004
43022224442001111100024442222034
11111111111422222222411111111111
