00000000000000000000000000000000
00000000000000000000000000000000
00000000000000000000000000000000
00000000000000000000000000000000
00000000000000000000000000000000
00000000000000000000000000000000
00000000000000000000000000000000
00000000444444444000000004444444
03400040000000000400440340000004
11444440111100000411001140000004
11000041111110000411001140111111
11000041134000000411001140111110
11000041140110000411001140110000
11000041142110000411001144010000
11020041140110000411201124112050
10444441140010000411001104111110
11044001140104444411001104111110
11440001140110000411001104110000
11400001140000000011001104110000
11402441140020000001021004000020
11111401111114000001111004111114
11111402111104000002112004111111
