00400000300000003404400004400002
00400000000000000044040004040004
04400004440000000044004004004004
40400040404000000404000404000404
20400400400400004004000044000044
00404000400040040004000004000004
44440000400004400004000004000004
40400000400004400004200024000044
40040000400042000004444444444404
44004400400004000004000000000404
40004400420444000004000000004404
40040403444004000044400000040404
40400400400004000404040000400404
44000040440004004004004004000404
40402004400004040004000440400404
44044000000004404004000400040404
40404000400004200400404000004404
40044040040004400040042000000404
44404000004004040004004040000424
40044000040404004000440404404440
40004000400044000400000000000400
00004000002000000025000000000400
