00000000000000000000000000000000
00000000000000000000000000000000
00030444440000000000044444030000
00000444440022000220044444000000
00000404440411111114044404000000
00041404040400200004040404140000
00041404040411111114040404140000
00041404044400500204440404140000
00002104014111111111410401200000
00001404044411111114440404100000
00001404044411111114440404100000
00040404040411111114040404040000
00044404040041111140040404440000
00044404040041111140040404440000
00044404040041122140040404440000
00044404040000000000040404440000
00044404040000000000040404440000
00004444040000000000040444400000
00000444440000000000044444000000
00000044440000000000044440000000
00000004440000000000044400000000
00000000341111111111143000000000
