44444444400004000000444444444000
00000000040000400004000000000000
00044444440200400004000000000000
00400000011100040004000000000000
00402030000000040004000000000000
00401111000000040000400000000000
00400000000000404440040000224440
00400000000004000000040000110000
00400000000004000200040000000000
00444440002040000100400000000002
00000004011040000004000000000001
00000004000004000001111111111111
00000004000000404400000000000000
00000004000000040000000000000000
00000004000000040000000000000000
00000004000000040000000000000000
00023204000000400000000000000101
00111104444404000001111111111101
20000000022004002000000000020231
10000000011004001001111111111111
00000000000504000000000000000000
11111111111111111111111111111111
