00000000000000000000000000000000
04444444444444444444444444444440
44000000000000000000000000000044
40011110000011111111000111111004
40010011000010000001000100001004
40010001100010000001000100001004
40010000100010000000000100000004
40010000100010000000000100000004
40010000100010000000000100000004
40010000100010000000000100000004
40010000100010000000000100000004
40010000100010000000000100000004
40010000100010000002000100000004
40010002100010000011000100002004
40010001100010000001000100001004
40012011000010000021000120021004
40011110000011111111000111111004
40000005000000000000000000000004
40411111111110011111100141111004
40410002111113311111140141121004
43410000111113311021140041111004
11111111111111111111111111111111
