00000000000200000000000000000000
00000000041111111100200000000000
00002000040000000111111000000000
11111111111400000000000000000000
00000000000400000000000200000000
00000000000411111110111111141100
00000000000400000000000000040000
30000000000400000000000000040000
11111111111400000000003000040002
11111111111411111111111000041111
11111111111400000000000000040000
11111111111400000000000000040000
11000000111400000000020444440000
11000000111400000000011000040000
11000000111400000000000000040000
11000000111400000000000000040000
11002200111400000002000000040000
11111111111141111111114000040000
00000000000040000000001111111114
00000000000040000000000000000004
00002000005040000000000000000004
11111111111111111111111111111111
