00000000000000000000000000000000
00000000000000000000000000000000
00000000000000000000000000000000
04003000111111103000020011110000
40411114111111141111111011111114
40411114000020041111121011112114
40411114111111111111111000011114
40410014000000004444444444444444
40412214000000000000000000000000
40111114000000000000000000000000
40000014000000000000000000000000
41114014300000000000002002000000
42014014111111111111111111402020
11014014444444404444444441111111
00024014000000202000000040052002
11411014111111111111111141111114
11400004444444444444444440000004
11400024000000200000000111111404
11411111111111111111110100020404
21410000000000000000000111111104
11410000020000202000000100030004
11111111111111111111111111111111
