00000000000000000000000000000000
53044440000000000000000000000000
00400004000000000000000000000000
04400004000000000000000000000000
44000004000000000000000000000000
44000004000000000000000000000000
04400004000000000000000000000000
00440004000000000000000000000000
00044004000000000000000000000004
00004004400000000000000000000004
00000124444444402044000440204444
00000114000004311104444431410004
01111114111111111111111110411114
10000004000001000111000021400004
14444444444441004444444444444444
10000004000001040001040401000004
11111114111111040111110411111114
00000111110001040100010411000114
00000004444044040440440414404414
00000014100200040002000400020004
00000214100100040001000400010004
11111004001110040011100401111104
