11111111111111111111111111111101
44444444444444444444444440000001
40004000000000000000000040000001
40004000000011003200000040000001
40004011111111111111111111111141
40004011100000000000000000000041
40004011100000000000000000000041
40004001101111111111111111111111
40004004100000010000100001000011
40004004100020010200102001002011
40004004114111111111111111111111
40004004114111110111111100000001
40004444004111110111111100000001
40004004004111110110000000000001
40004004004000010210000000030001
40004004004444011114444441111111
40004004004004000004000001111111
40004004004004444004000001111111
40004004004004004014111110202021
40004004004004004014111114111111
40004054004034004004111114111111
11111111111111111114020204111111
