00000000000000000000000000000000
00000000000000030000003000000000
11411414141414141414141414114110
11411414141414141414141414114110
11411414141414141414141414114110
12411404142414041424140414214110
11411414141414141414141414114110
11411414141414141414141414114110
11411414141414141414141414114110
11411414141414141414141414114110
10411424140414241404142414014110
11411414141414141414141414114110
11411414141414141414141414114110
11411414141414141414141414114110
20400404040404040404040404004110
41111111111111111111111111111110
40000000000000000000000000000000
40000000000000230202003000000000
41111111111111111111111111111110
40000000000000000000000000000000
42000000500000000000000000000020
11111111111111111111111111111111
