04444444444440020000000000000000
40000000000011111400000000000000
40000000000005020400000000000000
40000000000041111100002000000200
40000000000040000000111111411111
40000000000040020000000000400000
40000000000011111400000000400000
40000000000000000443000000400000
41111111140000020400411111111114
40000000040041111100411111111114
40000000440040000000410000200014
40000024410040020000414111111414
40000044100011111400414100000414
40000441000000000400414100200414
40024410000000020400414111111114
40044100000041111100414000000004
40041000000040000000414000200004
40410000000040020000411111111111
44100000000011111400400000000000
44000000000000000400400000000000
44000300000000000000400030000000
11111111111111111111111111111111
