00000000000000000000000000000000
00000000000000000000000000000000
00000000000000000000000000000000
00000000000000000000000000000000
00000000000000000000000000000010
01000000000000000000000000000100
00100000000000000000000000001000
44410000000001202100000000014444
40001444444444141444444444100004
44440120400000242000004021004444
00040014444444141444444410004000
00040001404001040100404100004000
44440000104010040010401000004444
40000000004100000001400000000004
40000000044100000001440000000004
44440011104105020001401110004444
00040011104111111111401110004000
00040011104101111101401110004000
02240012104101121101401210004220
44443011104101111101401110034444
44444400004000000000400004444444
41111111414111111111411111111114
