00000000000000000000000000000000
00000000000000000000000000000000
00000000000000000000000000000000
00000000000000000000000000000000
00000000000000000000000000000000
44444444444440000000000000000000
00000000000004000000000000000000
00200020002034000000010004040000
11111111111114000000011110401111
22000000000224444444011110401111
11200000002110000000401110401111
11120000021110444444410110401221
11112000211114000000010110401111
11111202111114444444410110401221
11111121111110003000410110401111
11111111111114111111112210401221
00000000000004000000011110401111
10100000005004000000000003401221
10111111111111114111111111111111
10000000111121114111112000000000
10000000111112114112021140000002
10200002111111004001111111111111
