00000000000000000000000003330000
00000000000000000000002222220000
00000000000000022222201111111000
00000000222222011111110000000000
00000000111111100000000000000000
00000000000000000000000000000000
00000000000000000000000000000000
00000000000000000000000000000000
22220000000000000000000000000000
11114000000000000000000000000000
11111114000000000000000000000000
11111111114000000000000000000000
11111111114000000000000000000000
11111111114000000000000000000000
11111111111111111114000000000000
11111111111111111111114000000000
11111111111111111111111114000000
11111111111111111111111111114000
11111111111111111111111111114000
11111111111111111111111111110400
11111111111111111111111111111400
11111111111111111111111111111450
