00000000000000000000000000000000
00000000000000000000000000000000
11111114000000000000000000041111
00000004000300000000000003040000
00000004111111111111111111140000
00000004000000000000000000040000
00010004000000000000000000040000
00100444000000000000000000040000
00102024000021200000000022240000
00101214440010102220000011144400
01001214202442101110000012142024
01001114121021202220000011141210
01000014212011101110000012142120
10000014121000000000000011141210
00000004040000000000000000044400
00000004040000000000000000040000
00000004440000000000000000040000
00000004040000000000000000040000
00000004000000000000000000040000
00000004000000000000000000040000
00000004000050000000000000040000
11111111111111111111111111111111
