00000000000000000000000000000000
00000000000000000000000000000000
00000000000000000000000000000000
00000000000000000000000000000000
00000000000000000000000000000000
00000000000000000000000000000000
00000000000000000000000000000000
00000000000000000000000000000000
04444444000004444444444410000010
00000004444444000000000410200010
02000004000004003020000411111114
11100201440001111111111111111114
11111111040200000000000002000004
11111120041100002120000011000004
11111112041100021112000011000004
11111111241100211111200011030204
11111111141111111111111111141114
10000000340000000000000000040114
10020001140000000000500000040114
11111111144444444411114200040114
10020000040002000411214100142114
11111111111111111111114111141114
