10000000000000000001111111111110
13000000000300000001002010000000
11444444111114000501041014111110
11000000000011111111041014111110
10000000000000000111041014100000
11111100002000000000041014100000
10000111111100000000041014100000
11114000000100000000041014100000
10011111140111111402041014100000
10020000140000000411111014102000
11111100111140000400001014111110
10000100000111111400001014111110
10200114100000001111141014100000
11110004100000000000141014102020
10010004111111100020141014111110
10011114000000111111141014111110
10000014000000000000141014100110
10041111111114020000141014100010
10041000000211111141141014100000
10041000000000000040041004000000
10041000000000000040241004000020
10241111111111111111111111111111
