00000000000000000000000000000000
00000000000000000000000000000000
00000000000000000000000000000000
00000444000000000444444004000044
40004004111111111000000110111400
42004200100000001000000000000400
11441140100000001000000000000400
02400240100000001000001111000400
41104110100000001000000000000400
42004200100000001200000000000402
11401140100000001111011111104111
32400240100000001200000000004000
41144110100000001114010000104000
42004200100000000014001221004000
11401140100000000014000114444020
02400240100000000014000004001111
41104110100000000014003004000000
40004030100000000014111111114020
11401140100000000014100202014111
00400040100000000014141111114000
41104110130200140004140202004000
40504000111111111111111111111111
