11111000000000000000000111111111
11111000000000000000000111111111
00001111000000000000000111111111
00001111000002000002000110000001
41000001111111114111000110000001
41000000111111114011020100114001
41000000011111114001111100114001
41100000001111114000000000114001
41100000001111114000000002114000
41100000000111114000000001114200
41111020000011114004444444111114
41111111000001114020000000110004
40111111100000111111110000110004
40000004112000000000000000110004
11111114111000000000000002110004
11111114111100000300000001110004
00000004111112000000000211110004
00200004111111111111111111114111
41111111100030000000005000004111
41111110041111111111111111111111
40000000040000000000000000001111
40002000040000000000003000001111
