11111001110311100111010111444444
01000100100001001000110010001110
01000100100001001000010010050100
01000100100001001000000010000100
01000100100301000100000010000100
04020100100001000102444410020100
41111000100001000011000411111100
41010000100001000000100410000100
41011000100301000000100410000100
41001000100001000000010410000100
41001100100001041200010410000100
41000120100001041102010410000100
41000110011110041011104111001110
40000004444444440000444000000000
40000000000000000000000000000000
40002220000002220000000222000000
40004140000004140000000414000000
40004140000004140000000414000000
40004140000004140000000414000000
40004140000004140000000414000000
42224242222224242222222424222220
11111111111111111111111111111111
