00000000000000000111111111111111
00000000000000000111111111444441
00020000000000411002000001400001
11111111111111411111111001404021
00000000000000411000000001401111
00000000020000411000020001401111
41111111111111111011111001401111
40000000000000011000000001400000
40000030000020011000020001400300
11111111111111411011111001111114
00000000000000411000000000000004
00000020000000411000020000000004
41111111111111111011111000000004
40000000000000011000000000000004
40000000020000011000002000000004
11111111111111411011111001111104
00000000000000411000000001000104
00200000000000411000020001002104
41111111111111111011111000041104
40000000000000000000000000041004
40000300000000000050000000041024
11111111111111111111111111111111
