00000000000000000011111111111111
00000000000000000011111111111111
00000000000000000011111111111111
00000020000020000000000000000000
11111111111111114000000002000000
11111111111111111111111111111114
00000203000030020000000000000004
41111111111111111111111111111111
40000000000020000000020000000000
11111111111111111111111111111114
00000000000000000000000000000004
00000200000000000020000000000204
41111111111111111111111111111111
40000000000000000000000000000000
40000200030303000000000020000000
11111111111111111111111111111114
00000000000000000000000000000004
00020000000002200000000000200004
41111111111111111111111111111111
40000000000000000000000000000000
40000000020000000005000002000000
11111111111111111111111111111111
