00000000000000000000011111111111
11111101111111114444440000000001
10000000000000004050040030000001
11111141111111111111111111111111
14400040000411100001111110000001
14111111111041101101111111111111
14111111111041102101111100000001
14101111110141101101111100000001
14110002001141101101111100000001
14111111111141101101111111111111
14001000010041101101111100000001
14001000010041101101111101101101
14001000010041101101111102111201
14001200010041100001111101120111
14111111111141111111111111111111
14000101200044000000000000000341
14111111111104111111114111111141
14002111000004000000114000000041
14000000000004000000114000000041
14000000000004000000114000000041
14000000003004000200114000200041
11111111111111111111111111111111
