00000000000000000000000000000000
00000000000000000000000000000000
00000000000000000000000000000000
11111111111101111111111111111111
50100000011100001401000444444440
14000000040141101401411400000000
24111111140141100420400000000002
11111140040141100400444444400000
21111141112141100400400000001111
00000040000141100400400000000000
00000040000140011141400000000000
00000040000141144441400002000000
00000040000141002141110000000000
00000340020141111141040000000300
11111111410141000044441111111111
40000001410041111111040001444441
41000000411141201200111401040001
41000004110141001000000400040001
41111104102140001111111111141001
40000011101141111000000000040001
40000000030041201402000020040001
11111111111111112411111111140021
