00000000000000000000000000000000
00000000000000000000000000000000
00000000000000000000000000000000
00000000000000000000000000000000
00000000000000000000000000000000
00000000000000000000000000000000
44011111341110111431111104410000
41440204414444444144020441400000
24141414142114112414141414210000
10414441401044401041444140100000
01441414410400040144141441000000
41044444014011104104444401410000
41400000414102014140000041450000
41044444014011104104444401410000
01441414410400040144141441000000
10414441401044401041444140140000
24140404142114112414040414210000
41440204414004004144020441400000
14011111041114111401111104110000
14040204041144411404020404110000
14041414344144414434141404110000
41414441414444444141444141440000
