11111111111110000000111111111111
00040000004444440000004000000020
00340000004000000000004111110411
11101111111111111110004000011111
14440000000044444440004002000001
10040000000021101140304111111111
20140000000041121111140000000001
11144444444444444444144444444441
10010000000040000024111000000041
12010000000040000004111000000041
11110000022240000004100000000041
10000000000040000004100000002044
10000000000040000004144440001114
14111110000040005004140000000004
14444444000411111111140200000004
14000000000400000004140000000004
14200001111400000004140000000004
14144441111400000004140000000004
14000111111114000004140001111004
14011111111111140004040001021004
14011111111111140034040000111111
11111111111111111111111111111111
