00000400000400400000004400000000
00004440004444040000040040200020
00040404040004004000400041111111
00400400400004000404000040000000
00000400000004000440000040003000
00200420002004000400000041111114
11111111111111144000000041000014
00000000000000010000000041002014
00000000000000010000000041411214
00000000000002010005020041411014
41111111111141114111111441411214
40000000000041144111111041411214
40000030000041144000000041411214
40000110000041140000000001411014
40111001110041140000023001411214
40111001110041111111111141444444
40111221110041100000000040000000
40000110000041000004444440000000
40001111000041000000000240111100
42021111020241100004104111100110
11111111111111111111114100022011
11111111111111111111111111111111
