00020000000000000000000000000004
41111140000000000000000000000004
40000040000000000000002000000004
40000040000004111111111114000004
40203040000004000000000004020004
41111140000004000000000004111114
40000044440004000000000004000000
40000040000004000000000004000000
40000044444444444444400034000000
40000040000004000000411111111114
40000040000004000000400000000004
40000040000004002000400000000004
40003040200004111111400000000004
11111111111114000000000000000004
11111100000004000000000041111411
10001100000004000000000040000400
12001100000004000444444440000402
11111111141111111100000040001111
00000000040000000000000040000000
00000000040000000000000040000000
00000000040000005000000040000000
11111111111111111111111111111111
