00000010000000000000000000000000
00000010000000000000000000000000
00000010000000000000000000000000
00000010000000000000000000000000
00000014444444004440441140000000
20003214444442110004411440000000
11141110000021100044114420000000
00040010000211000441144201100000
20040210002110004411442011000000
11141110021100044114420110000000
00540010211000441144201102200000
11140212110004411442011041100000
11141111100044114420110042200000
12140010200443044201104111100000
11140211111111111141004203200000
21141114444444444441041111100000
11140212020040000001042000200000
11111111110040000001041111100000
00000000000040000001042000200000
00000000000040111101041111100000
00000000000341122111042000200000
11111111111111111111011111111111
