00000000000000000000000000030000
00000000000000000200000010101000
00000004444411111111111110101000
00000004000010000000000010101000
24444444000010000000200010101000
14000000000010000011111110101000
11400000003010000020000000101000
11140000002010000004444440101000
11114044444412000210000040000000
11111140000011111110000044400000
00000040000011111110000040000000
00000040000011111110000040111111
00000040000011111110000040120003
00000040000011111110000040111114
00000040000000000000000040000004
00000040000000000000000040000004
00000040000000000000000040000004
00000040000000000000000040000004
00000040000000000000000040000004
00000440000000000000000040000004
30021040000000005000000040000004
11111041112111111111111140011114
