00000000000000000000000000000000
00000000000000000000000000000000
00000000000000000000000000000000
00000000000000000000000000000000
00000000000000000000000000000000
00000000000000000000000000000000
00000000000000000000000000000000
00000000000000000000000000000000
00000000000400000000000000000040
00000111111400044444444444444440
00000100201400040000000000030040
00000100001400041111111111111111
11111111111111141444441111111001
02302000000200041040001444001001
11111111111111141041221222141201
04444444444444441041111111141001
43000000000000041042004444444411
41111111111111141111110000200400
40000000000000540002000001100444
42111111102011141111111401244004
41100002111110242111111401120114
11111111111111111111111400011111
