00000000000000000000000000000000
00044442000000000040200000020000
00400011100000000401110000114000
00400000000000000400000000004000
00400000030000000400030200004002
00444440200000000400011100004411
11400041110000000400000000000400
00002041110003000400000000000400
00111044044420444400000000000400
02000000400011030400000000000402
01110000400000000000000000024111
00000000400000000002000024411000
00000000400000000111000110400000
00000402400000000000000000400000
00004011400020000000020000400000
00004000000111000000111000402000
02004000002000000200000000411110
41114000011100001100000000000000
40000000000000000000000000000000
40000000000000000000000000000000
40000000000000050000000000000000
11111111111111111111111111111111
