00000000000000000000000000000000
01111111000000000000000000000000
01000001000000000000000000000000
01000001000000000000000000000000
01000001000000000000000000000000
01114111000000000000000000000000
00004000000000000000000000000000
00004000000000000000000300000000
00014241111414300002041111140000
00211411111411111411410000140000
00011400001400000401411111141114
00211401111402000401400110140024
00011402111401100401402110140114
00211401111400020401401010140114
00011401111401010401401100140114
00211400001400000421401120143024
00011411111411111411411111141114
00212444444440220400301100000124
00011114000011111114111200000214
00210004111211111114111111411114
02015004121122222204200000400004
11111111111111111111111111111111
