00000000000000000000000000000000
00000000000000000000000000000000
00000000000000000000000000000000
00000000000000000000000000000000
00000000000000000000000000000000
00000000000000000000000000000000
00020000000000000000000000000000
41110000000000000000000000001114
41211020000000000000000000201114
40012111000000000000003011111114
40010100111200000000011102000004
40000100100100002000112011110004
40011111100011111111100000011114
42050000000000000000011114102004
41111444444440000000000004111204
40001000032222000000000004001111
40201200111111111111110004021002
41111100000000000000000004111111
44444444444400000000000004000000
00000400000000000000000004000000
00000400000000000000000004300000
00020400011111111111111111111111
