10000400000005000000400000000000
11114011111111111111040001400000
11114010001111111101041111400044
11214010111111111001041111411104
11114010001111111101041111000004
12114010111111111001041111044444
11114010001111111101041121042000
11214010111111111001041111011114
11114010001111111101041211000204
12114010111111111001041111041111
11114010001111111101041111042000
11214010111111111001041111011114
11114010001111111101042111000204
12114010111111111001041111041111
11114010001111111101041111042000
11214010111111111001041211011114
11114010001111111101041111000204
12114012111111111221041120041111
11114011111111111111041111042000
11214011111111111111041111011114
11114000003000003000041111003004
11111111111111111111111111111111
