00000000000000000000000000000000
00000000000000000000000000000000
00000000000000000000000000000000
00000000000000000000000000000000
00020000000410000001400000002000
41111144444410000001444444111114
41000140000410000001400004100014
41000140000010000001000004100014
41000140000010000001000004100014
41020140000010000001000004102014
41111140000010000001000004111114
41000140000010000001000004100014
41000140000010000001000004100014
41000140000014111141000004100014
41000144444414000041444444100014
41000100000414000041400000100014
41320100000414002341400000102014
41111100000411111111400000111114
40000110000400000000400001100004
40000011000400000000400011000004
40000001130400005000400110000004
11111111111111111111111111111111
