00002000020002303200200000200000
11111111111111101111111111111111
00000000000000040000000000000000
00000000000000040000000000000000
00000000000000040000000000000000
00000000000000040000000000000000
00000000000000141000000000000000
00000000000000242000000000000000
00000000000000040000000000000000
00000000000001141100000000000000
00000000000002040200000000000000
00000000000000040000000000000000
00030000000011141110000000300000
00040000000020040020000000400000
00141000000000040000000001410000
00242000000111141111000002420000
01141100000200040002000011411000
02040200000000040000000020402000
11141110001111141111100111411100
20040020002000040000200200400200
00040000000000040500000000400000
11111111111111111111111111111111
