00000044444444444442000000000000
11111100011000000011111111114000
14444440022000000010000000014000
14000000111100000010000000214000
14220000200200000011111111114000
11114020111100000000000000344000
00004000000002000020000034404000
00004000001111111111111114404000
00004230201300000000200010004000
00004111141111111111111110004000
00000100140000000000000000004000
00000100140000000000000000004000
00000100140000000000000000004000
00000100140000000000000000004000
00000100140000000000000000004000
00000100140000000000000000004000
00000100140000000000000000004000
00000100140000000000000000004000
00000122140000000000000000004000
00000111140000000000000000004000
00000000040000000300050000004000
11111111111111111111111111111111
