00000000000000000000040000000000
00000000000000000000040000000000
20002000444403000044440320000000
11114444000040000444411114140000
00004000111142044444212000140000
11111400000044411000111111140000
12000400000000400000111104440000
01200400000002402000000041040000
00120411114111111111411141000000
00412400004000200000400041000000
00401410004111111111411141000000
00400400004000000000400141000000
00404400004000200000401242100000
00410000204111111111401141100000
00400000104000000000400040000000
00400200004000000000400040000000
00400100004000200000400040000000
00400000004111111111400040000000
00400000004000000000400040000000
00400000004000000000400040000000
00400000004000000000400340000000
11111111114000300005411111111111
