11111111111111111111101111111111
10000000000000000000100000000001
10200000000000000000100032000001
11111411114000020000101111111141
11111411111111111111111011110041
10000400203000000111111011110041
14111111111411111111111011110041
14000111111411111112211011110041
14000111111411111111111011110241
14000111111411111100001111111141
14000100000400000000000000000141
14000100002400002000003000200141
14000114111111114111111111114141
14000114000000004111111111114141
14002114005000040111111100004141
14111104000000400000111100004141
14111104000041111111111100004141
14111104000041111111111100004141
14111141111141111111111120204141
14111141111141111112111111111141
14300041121140000020003000000041
11111111111111111111111111111111
