00000000000000000000000000000000
00000030000000000000000000000000
41111111114000302000000002000000
40000000004111114000000111114111
40000000004000014000000000004000
40000000004022014000300000004000
40200000204011011111111111111111
40100110104011000000000000000012
40101100104011000000000000000014
40100110104010444444444442000014
40101100104010000000000011114114
40100110104012000000000000004004
40101100104011000000000000004111
40120110104011000000000000004000
40111100104011000000200000004000
40111111104011011111111111004000
40000000004011000000000000004000
41111111111111000000000000004000
40000000000000000000000000004000
40000000000000000000000000004000
40000000000005000000000000004000
11111111111111111111111111111111
