00000000000000000000000000000000
44444444444400000200000000000000
40000000000411111111111114000000
40000000000400000000000004000000
40200000000400000000000004111111
11111140000400000000000004000000
00000040030400000002000004000000
00000041111114111111141111000000
00000040000004000000040000440000
00000040000004000000040000004400
00020040000004000300040000000044
11111410004111111141110000000000
00000400004000000040000000000002
00000444444000000040030000000001
00000400000004111111111140000000
00000400000004111111111140000000
00000400000004111111111140000000
11114111111111100000200111111141
11114111111111104111140111111141
00004000000000004111140000000040
00004000000005004111140000200040
11111111111111111111111111111111
