00000000000000000000000000000000
00000000000000000000000000000000
00000000000000000000000000000000
00000000000000000000000000000000
00000000000000000000000000000000
00000000000000000000000000000000
00000000000000000000000000000000
00000000000000000000000000000000
00000000000000041114000000000000
00000000000000041114000000000000
00000000000000041114200000000000
00000000004111111111140000000000
00000000004100000000140030000000
01400003004100000000140141100000
00111114111102020000111141140000
00011114111111111111111141140000
00001100200011111110200042011140
00000111114002000001140041420140
00000011014111111400040040114140
00000001214111111142040042114140
00300000111111111111111111111145
11111111111111111111111111111111
