00000000000000000000000000000000
00000000000000000000000000000000
00000000000000000000000000000000
00000000000000000000000000000000
00000000000041111111111111111100
11441114111140000000004444444400
10141014100140000000000000000000
12141014100140000000000000000000
10141014100140000000000000000000
10141214120140000030000000000410
10141014100141111111111110020410
10141014100144442444424441114110
10441014100144111144111440204142
44444444444444100244100441141140
40000040011044104144102441041444
40011140012144111144111441411410
44412040001144444404444441400410
40011040010140024004444411114144
40000040511041114111002411104040
44444441111141444441011411104140
40000000001141404041011401141440
11111400003001404241002413041400
