44444444444421111111244444444444
40000000002211444441122000000004
40000000021144444444411200000004
40000000011444440444441100000004
40000000014444430344444100000004
40000000214444000004444120000004
40000000114440000000444110000004
40000000144420000000244410000004
40000000144200000000024410000004
40000000142200000000022410000004
40000000144200000000024410000004
40000000114420000000244110000004
40000000014442000002444100000004
40000000014444200024444100000004
40000000011444420244441100000004
40000000001144442444411000000004
40000000000111444441110000000004
40000000000001111111000000000004
40050000003001111111003000000004
11111111111400000000041111111111
00000000000400000000040000000000
00000000000400000000040000000000
