00000000000000000000000000000000
00000000000000000000000000000000
00000000000000000000000000000000
00000000000000000000000000000000
00000000000000000000000000000000
00000000000000000000000000000000
00000000000000000000000000000000
00000000000000000000000000000000
11111111111111111114110200000500
00000000000030000004111111111114
20044444444444444404000000000004
12040044444444444404020204111114
01240040000000000004010101111114
00140042020202020200401000000004
00012041111111111104000003202024
00001040000000000000400001411114
00000040404040404004000000400000
00000040000000000000400000403000
00000004040404040004000000111114
00000000404040404000400000000004
00003000000020010004000300000004
11111111111111111111111111111111
