00440000000020020000044440010014
11001400000411114000403001110004
01101400004111111111111401110014
11001411111121121111111401211114
21121400000030000000000400000014
11111111111111111111111111111114
00000000000000000000000000000004
00000000000000000000000000000004
00000000000000000000000000000004
00000000000000000000000000000004
00000000000000000000000000000004
00000000000000000000000000000004
00020300002000000000005000030004
11111111111111114111111111111111
04444444444444014000000000000000
40000004000000414444444444444440
40000040400000411110011001100114
40000401040000411111111111111114
40004011104000444444444444444444
40040111110400411111111111111111
40401122211040410000000000000000
44011111111104410000000000030000
