11111111111111000111111111111111
14444444444411404114444444444441
10000000000414404414000000000001
10000000020444000444020000000001
10000020011400202004110020000001
10002011144411101114441110200001
10021114444114404411444411102001
12011444444444404444444444111021
11114444444444404444444444441111
11444444444444404444444444444411
14444444444444404444444444444441
10000434040404404404040434000001
10000411111111454111111114000001
10000400000000111000000004000001
10000400000000121000000004000001
10000400000000101000000004000001
10020400000000101000000004020001
40000400000030101003000004000004
44444411111111404111111114444444
40020040000000404000000040020004
40000040000200404002000040000004
11111111111111111111111111111111
