00000000000000000000000000000000
01110001111100111000000000000000
01001004401001000100000000000000
01000140031001000100000000000000
01000141001001111100000442440000
01201041021001000100002004002000
01110040110001000101002004002000
00000040000000000000000004000000
00000040000000000000000004000000
00500040000200200000000204023000
01111111111111111111111111111110
00000000000000003000000000000000
00000000000000000000000000000000
00000044444020000000000000000000
00000000020044400044444404440000
00040400000040040000040040004000
00404040020040004000040040204000
00204020000040004440040044444000
00204020020040040040240040004000
00004000000044400004440040004040
00004000020000002000000000204000
11111111111111111111111111111111
