00000000000000000000000000000000
00302000000000000000000000000000
11111111111411111110000000000000
00000000000444444444444000000000
00000000000400001140000000000000
00000000000400301140000002000000
00000000000400001140001111141111
00000000000400001140000000040000
00000000000400001140000000040000
00000000000400001140000000240000
11141111111100001111111141111111
00040000000000000000000040000000
00040000000000000000000040000000
00040000000000000000000040000000
11111111111111411111111140000000
00000000000000400000000040000000
00000000000000400000000040000000
00000000003020444444444440020300
00000041111111110000000011111114
00000040000000000000000000000004
00000040000000000500200000000004
11111111111111111111111111111111
