00000000000000000000000000000000
00000000000024042000000000222202
00000000000010401000000000111141
00000000000001410000000000000040
00040000000000400000000000004140
00041111111111400000000000004000
00040000000000400000000000004000
00040000000050400000000000024222
00040000002200411111111140011114
00040100002200400000000040010004
00040000022220400020000040010004
00040000022220400220000040010004
00040000222222402222000040010004
00040000222222422222000040010004
04440002222222222222200040014444
00040002221222222222200040014001
00040022222222222122220040014304
00040022222222222222220040011114
02040022222222222222220040002004
22044444444444444444444440041404
22240040020003000220040040041404
11111111111111111111110110440000
