10000000000000000000000000000001
10000000000000000000000000000001
10000002003000004444444444444421
11111111111111144000000002000411
11110000000000044111111111111110
11111002003000044000000000110000
11111111111111144000200001114000
11111111111111144111111111004000
11111110000000044000000111114000
11111110000000044002001100004000
00020011002000044111111020004000
41111111111111144000111111114000
41101011110000044001102000004000
40040400211000044111111111114000
11140404111150044100000000004000
11111404000111144000000000004000
11111114444101144000000000004000
00000000004040044000000000004000
00000000004040044000000000004000
00000000004040044000000000004000
00000000004040044000000000004000
11111111111111111111111111114111
