11111111111111111111111000000001
11005110000100000000000000000001
10000114444100000200000000000001
10011100204111111111440414004001
10100000004000000110442404004001
10100000004000000011440404004001
10141111111111000000440404114001
10141000000000110000440404004001
12041000020000110041040404004001
11441111111111111141210114114001
11400000000000000041110104004001
11400000000000000041010104004001
11400000003000000041010104004001
11411111111111111441010104004001
11401111111111111444010104004001
10400100000000001440010104004341
10400010020000001400010144111141
10414111111111111400210140000041
10414111111111111411110143000041
10114100000000001111110111110041
10114100000020001000000000010041
10204011111111111000300000011111
