00000000000000000000000000000000
00000000000000000000000000000000
00000000000000000000000000000000
00000000000000000000000000000000
00000000000000000000000000000000
00000000000000000000000000000302
00000000000000000000000101411111
00003000000000001000000101411111
41111101111111411000004101411111
40000000444000412111114101410021
11411011004130401111114101411111
00400112104010411000004101411111
41000111114001400000414101400000
40000500004000114000414000111114
41111111101021004002414111111114
41111111111010001111114010000004
41111111111000000021114001111111
41120001111444444410014444444400
41100021111400000100012000001014
41111111111400001111111141111214
40001120000400010000000040001114
41111111111411111111111111100004
